GEO.id,GEO.id2,GEO.display-label,HD01_VD01,HD02_VD01,HD01_VD02,HD02_VD02,HD01_VD03,HD02_VD03
1600000US0107000,0107000,"Birmingham city, Alabama",90186,3374,40295,2507,49891,3372
1600000US0121184,0121184,"Dothan city, Alabama",25192,875,14935,763,10257,722
1600000US0135896,0135896,"Hoover city, Alabama",34058,1330,22913,1724,11145,1482
1600000US0137000,0137000,"Huntsville city, Alabama",84750,2687,46677,2948,38073,2680
1600000US0150000,0150000,"Mobile city, Alabama",78145,2673,41297,2323,36848,2325
1600000US0151000,0151000,"Montgomery city, Alabama",78217,2248,42766,2102,35451,2473
1600000US0177256,0177256,"Tuscaloosa city, Alabama",36209,1769,17203,1570,19006,1783
1600000US0203000,0203000,"Anchorage municipality, Alaska",107373,1962,62826,2361,44547,2490
1600000US0404720,0404720,"Avondale city, Arizona",26223,1632,15766,1518,10457,1582
1600000US0407940,0407940,"Buckeye city, Arizona",18135,1433,14136,1587,3999,852
1600000US0410670,0410670,"Casas Adobes CDP, Arizona",30011,2003,18760,1545,11251,1592
1600000US0412000,0412000,"Chandler city, Arizona",91671,2678,59939,2939,31732,2415
1600000US0423620,0423620,"Flagstaff city, Arizona",24493,1823,12643,1410,11850,1642
1600000US0427400,0427400,"Gilbert town, Arizona",81415,2444,57390,2571,24025,2332
1600000US0427820,0427820,"Glendale city, Arizona",79570,2727,41705,2687,37865,2213
1600000US0428380,0428380,"Goodyear city, Arizona",25532,1683,19646,1906,5886,1133
1600000US0446000,0446000,"Mesa city, Arizona",177276,3969,109202,3956,68074,3513
1600000US0454050,0454050,"Peoria city, Arizona",62112,2501,47377,2116,14735,1734
1600000US0455000,0455000,"Phoenix city, Arizona",559155,6855,313820,6602,245335,6125
1600000US0464210,0464210,"San Tan Valley CDP, Arizona",29224,2515,21702,2203,7522,1736
1600000US0465000,0465000,"Scottsdale city, Arizona",110192,3330,72913,3590,37279,2987
1600000US0471510,0471510,"Surprise city, Arizona",50799,2220,37677,2274,13122,1467
1600000US0473000,0473000,"Tempe city, Arizona",70555,3602,27608,2542,42947,2861
1600000US0477000,0477000,"Tucson city, Arizona",211560,3807,108108,3468,103452,3850
1600000US0485540,0485540,"Yuma city, Arizona",35353,1844,21725,1782,13628,1803
1600000US0515190,0515190,"Conway city, Arkansas",24623,1402,11685,1255,12938,1628
1600000US0523290,0523290,"Fayetteville city, Arkansas",34393,1880,13228,1658,21165,2173
1600000US0524550,0524550,"Fort Smith city, Arkansas",34903,1835,17476,1547,17427,1708
1600000US0535710,0535710,"Jonesboro city, Arkansas",29975,1416,15289,1478,14686,1491
1600000US0541000,0541000,"Little Rock city, Arkansas",79869,3117,44645,2669,35224,2779
1600000US0550450,0550450,"North Little Rock city, Arkansas",26595,1550,11561,1378,15034,1538
1600000US0560410,0560410,"Rogers city, Arkansas",23710,1384,13412,1258,10298,1331
1600000US0566080,0566080,"Springdale city, Arkansas",26417,1674,14053,1934,12364,1586
1600000US0600562,0600562,"Alameda city, California",30662,1597,14011,1290,16651,1511
1600000US0600884,0600884,"Alhambra city, California",30255,1503,11545,1293,18710,1682
1600000US0602000,0602000,"Anaheim city, California",98734,3360,43552,2765,55182,2710
1600000US0602252,0602252,"Antioch city, California",34423,1971,21204,1926,13219,1613
1600000US0602364,0602364,"Apple Valley town, California",24050,1719,15174,2153,8876,1504
1600000US0602553,0602553,"Arden-Arcade CDP, California",40788,2407,16773,1791,24015,2273
1600000US0603526,0603526,"Bakersfield city, California",118508,2821,66449,3151,52059,3493
1600000US0603666,0603666,"Baldwin Park city, California",17725,1006,9503,1124,8222,1178
1600000US0604982,0604982,"Bellflower city, California",24796,1241,9448,1059,15348,1393
1600000US0606000,0606000,"Berkeley city, California",43770,1567,19261,1717,24509,1611
1600000US0608786,0608786,"Buena Park city, California",23627,1502,12510,1510,11117,1247
1600000US0608954,0608954,"Burbank city, California",40981,1999,16729,1276,24252,1971
1600000US0610046,0610046,"Camarillo city, California",25361,1403,17038,1579,8323,1325
1600000US0611194,0611194,"Carlsbad city, California",45588,1917,30220,2078,15368,1838
1600000US0611390,0611390,"Carmichael CDP, California",25537,1932,14243,1495,11294,1566
1600000US0611530,0611530,"Carson city, California",26070,1338,18338,1579,7732,1377
1600000US0611964,0611964,"Castro Valley CDP, California",21977,1541,16109,1497,5868,1243
1600000US0613014,0613014,"Chico city, California",37547,1963,16303,1522,21244,1749
1600000US0613210,0613210,"Chino city, California",20484,1467,12228,1311,8256,1092
1600000US0613214,0613214,"Chino Hills city, California",23170,1156,18119,1280,5051,1131
1600000US0613392,0613392,"Chula Vista city, California",80417,2948,45564,3082,34853,3207
1600000US0613588,0613588,"Citrus Heights city, California",33598,1595,18545,1550,15053,1526
1600000US0614218,0614218,"Clovis city, California",35855,1812,22543,1748,13312,1531
1600000US0615044,0615044,"Compton city, California",23360,1503,12209,1376,11151,1317
1600000US0616000,0616000,"Concord city, California",45868,2102,28379,2306,17489,1876
1600000US0616350,0616350,"Corona city, California",47942,1795,31162,1911,16780,1604
1600000US0616532,0616532,"Costa Mesa city, California",40927,1838,16418,1583,24509,1705
1600000US0617918,0617918,"Daly City city, California",29162,1841,16796,1504,12366,1448
1600000US0618100,0618100,"Davis city, California",23271,1258,10797,1027,12474,979
1600000US0619766,0619766,"Downey city, California",33578,1943,17537,1619,16041,1576
1600000US0620802,0620802,"East Los Angeles CDP, California",31910,2054,9890,1259,22020,1978
1600000US0621712,0621712,"El Cajon city, California",33587,1950,12929,1511,20658,1814
1600000US0622020,0622020,"Elk Grove city, California",53661,2046,39088,2062,14573,1839
1600000US0622230,0622230,"El Monte city, California",27987,1698,11836,1396,16151,1449
1600000US0622804,0622804,"Escondido city, California",46250,2261,22811,2042,23439,1922
1600000US0623182,0623182,"Fairfield city, California",37324,1696,20495,1900,16829,1802
1600000US0624477,0624477,"Florence-Graham CDP, California",14918,1445,5789,1066,9129,1170
1600000US0624638,0624638,"Folsom city, California",28094,1582,19619,1587,8475,1377
1600000US0624680,0624680,"Fontana city, California",52767,1948,35302,1986,17465,1670
1600000US0626000,0626000,"Fremont city, California",72148,2037,46122,2185,26026,1825
1600000US0627000,0627000,"Fresno city, California",169409,3216,79723,3181,89686,3599
1600000US0628000,0628000,"Fullerton city, California",45632,2271,22958,2237,22674,1882
1600000US0629000,0629000,"Garden Grove city, California",48036,1801,24766,1659,23270,1566
1600000US0630000,0630000,"Glendale city, California",74613,2255,24637,2029,49976,2441
1600000US0632548,0632548,"Hawthorne city, California",29450,1775,7063,1143,22387,1782
1600000US0633000,0633000,"Hayward city, California",46860,1709,24593,1643,22267,1626
1600000US0633182,0633182,"Hemet city, California",29725,1974,18035,1597,11690,1708
1600000US0633434,0633434,"Hesperia city, California",25398,1500,17213,1520,8185,1444
1600000US0636000,0636000,"Huntington Beach city, California",77155,2468,44900,2990,32255,2079
1600000US0636448,0636448,"Indio city, California",35675,2401,25949,2433,9726,1517
1600000US0636546,0636546,"Inglewood city, California",35788,2023,12878,1375,22910,1875
1600000US0636770,0636770,"Irvine city, California",97161,3469,45478,3063,51683,3422
1600000US0637692,0637692,"Jurupa Valley city, California",23784,1438,16502,1192,7282,1100
1600000US0639248,0639248,"Laguna Niguel city, California",26133,1430,19630,1653,6503,1168
1600000US0639486,0639486,"Lake Elsinore city, California",16388,1340,10663,1206,5725,1272
1600000US0639496,0639496,"Lake Forest city, California",29519,1435,20436,1842,9083,1290
1600000US0639892,0639892,"Lakewood city, California",25186,1579,17703,1477,7483,1056
1600000US0640130,0640130,"Lancaster city, California",48327,1659,26417,1880,21910,1870
1600000US0641992,0641992,"Livermore city, California",33085,1818,23812,1636,9273,1376
1600000US0642202,0642202,"Lodi city, California",22454,1594,10771,1204,11683,1449
1600000US0643000,0643000,"Long Beach city, California",167447,4073,68066,2945,99381,3524
1600000US0644000,0644000,"Los Angeles city, California",1384851,9554,506790,9196,878061,10855
1600000US0644574,0644574,"Lynwood city, California",15263,1049,6703,960,8560,1295
1600000US0645022,0645022,"Madera city, California",18079,1409,8406,1747,9673,1622
1600000US0645484,0645484,"Manteca city, California",24573,1651,15378,1325,9195,1451
1600000US0646842,0646842,"Menifee city, California",28891,1770,21923,1780,6968,1276
1600000US0646898,0646898,"Merced city, California",26278,1384,10577,1288,15701,1495
1600000US0647766,0647766,"Milpitas city, California",22128,1321,14364,1340,7764,1423
1600000US0648256,0648256,"Mission Viejo city, California",33936,1502,26511,1651,7425,1165
1600000US0648354,0648354,"Modesto city, California",72621,2257,39131,2728,33490,2614
1600000US0649270,0649270,"Moreno Valley city, California",48908,2226,28738,1939,20170,1840
1600000US0649670,0649670,"Mountain View city, California",33177,1930,13709,1457,19468,1614
1600000US0650076,0650076,"Murrieta city, California",32407,1686,21943,1809,10464,1591
1600000US0650258,0650258,"Napa city, California",28790,1272,17415,1271,11375,1419
1600000US0651182,0651182,"Newport Beach city, California",37968,2094,22209,1432,15759,2096
1600000US0652526,0652526,"Norwalk city, California",27661,1404,18216,1240,9445,1299
1600000US0653000,0653000,"Oakland city, California",158851,3580,62467,2818,96384,3782
1600000US0653322,0653322,"Oceanside city, California",61138,2632,35832,2261,25306,1989
1600000US0653896,0653896,"Ontario city, California",50572,1952,27061,2367,23511,2279
1600000US0653980,0653980,"Orange city, California",42663,1984,24385,2093,18278,1587
1600000US0654652,0654652,"Oxnard city, California",52717,2142,28541,2067,24176,1966
1600000US0655156,0655156,"Palmdale city, California",42005,1857,25367,2055,16638,1941
1600000US0655282,0655282,"Palo Alto city, California",25439,1264,13389,1383,12050,1351
1600000US0656000,0656000,"Pasadena city, California",54177,2088,22972,1907,31205,2190
1600000US0656700,0656700,"Perris city, California",15947,1152,10468,1120,5479,1204
1600000US0657456,0657456,"Pittsburg city, California",20784,1354,11433,1328,9351,1374
1600000US0657792,0657792,"Pleasanton city, California",30435,1271,20990,1265,9445,1526
1600000US0658072,0658072,"Pomona city, California",38980,1753,21445,1744,17535,1871
1600000US0659444,0659444,"Rancho Cordova city, California",25850,1258,13589,1399,12261,1030
1600000US0659451,0659451,"Rancho Cucamonga city, California",52731,2228,33620,2289,19111,2350
1600000US0659920,0659920,"Redding city, California",38036,1437,20314,1590,17722,1610
1600000US0659962,0659962,"Redlands city, California",26264,1937,15628,1834,10636,1958
1600000US0660018,0660018,"Redondo Beach city, California",28081,1670,14499,1463,13582,1467
1600000US0660102,0660102,"Redwood City city, California",32344,1632,16319,1730,16025,1381
1600000US0660466,0660466,"Rialto city, California",26699,1427,16339,1687,10360,1458
1600000US0660620,0660620,"Richmond city, California",37029,2003,18859,1765,18170,1904
1600000US0662000,0662000,"Riverside city, California",86905,3358,46148,3002,40757,2623
1600000US0662938,0662938,"Roseville city, California",50198,1840,32728,2112,17470,1885
1600000US0664000,0664000,"Sacramento city, California",189193,3813,91978,3722,97215,3893
1600000US0664224,0664224,"Salinas city, California",41218,1864,18880,1546,22338,1590
1600000US0665000,0665000,"San Bernardino city, California",60714,2587,29869,2250,30845,2458
1600000US0665042,0665042,"San Buenaventura (Ventura) city, California",41338,2042,21649,1886,19689,1964
1600000US0665084,0665084,"San Clemente city, California",25366,1410,16680,1563,8686,1321
1600000US0666000,0666000,"San Diego city, California",504208,6575,237233,5691,266975,6615
1600000US0667000,0667000,"San Francisco city, California",360323,4331,131576,4311,228747,5151
1600000US0668000,0668000,"San Jose city, California",321913,4299,184716,4083,137197,4251
1600000US0668084,0668084,"San Leandro city, California",33458,1851,18890,1842,14568,1841
1600000US0668196,0668196,"San Marcos city, California",29611,1537,19199,1599,10412,1314
1600000US0668252,0668252,"San Mateo city, California",39660,1656,20788,1657,18872,1579
1600000US0668378,0668378,"San Ramon city, California",24317,1016,17834,1066,6483,851
1600000US0669000,0669000,"Santa Ana city, California",76650,2880,35239,2454,41411,2431
1600000US0669070,0669070,"Santa Barbara city, California",40145,2149,16755,1764,23390,1882
1600000US0669084,0669084,"Santa Clara city, California",43159,2137,18445,1588,24714,1921
1600000US0669088,0669088,"Santa Clarita city, California",67564,2152,45075,2076,22489,1784
1600000US0669112,0669112,"Santa Cruz city, California",23585,1703,10868,1389,12717,1641
1600000US0669196,0669196,"Santa Maria city, California",27968,1586,14064,1383,13904,1322
1600000US0670000,0670000,"Santa Monica city, California",45258,2086,13529,1649,31729,2383
1600000US0670098,0670098,"Santa Rosa city, California",64155,2395,35289,2075,28866,1947
1600000US0672016,0672016,"Simi Valley city, California",40822,1752,28266,1882,12556,1465
1600000US0673080,0673080,"South Gate city, California",24019,1209,10306,1201,13713,1592
1600000US0673262,0673262,"South San Francisco city, California",20939,1598,11831,1369,9108,1423
1600000US0675000,0675000,"Stockton city, California",91392,2741,45926,2850,45466,2763
1600000US0677000,0677000,"Sunnyvale city, California",55024,2106,25645,1969,29379,1849
1600000US0678120,0678120,"Temecula city, California",34277,1524,21705,1769,12572,1714
1600000US0678582,0678582,"Thousand Oaks city, California",46017,2083,32860,1863,13157,1721
1600000US0680000,0680000,"Torrance city, California",54327,1993,30769,2019,23558,1914
1600000US0680238,0680238,"Tracy city, California",25830,1752,16325,1697,9505,1335
1600000US0680812,0680812,"Turlock city, California",25562,1396,13652,1537,11910,1536
1600000US0680854,0680854,"Tustin city, California",27780,1909,13033,1349,14747,1804
1600000US0681204,0681204,"Union City city, California",22684,1248,14920,1305,7764,1344
1600000US0681344,0681344,"Upland city, California",25582,1347,14371,1374,11211,1411
1600000US0681554,0681554,"Vacaville city, California",34017,1619,19677,1522,14340,1561
1600000US0681666,0681666,"Vallejo city, California",41719,1666,23000,1746,18719,1783
1600000US0682590,0682590,"Victorville city, California",35088,2351,19493,2503,15595,2342
1600000US0682954,0682954,"Visalia city, California",43785,1730,26382,2072,17403,1856
1600000US0682996,0682996,"Vista city, California",31618,1734,16549,1615,15069,1541
1600000US0683346,0683346,"Walnut Creek city, California",31648,1529,20843,1646,10805,1489
1600000US0684200,0684200,"West Covina city, California",29807,1647,18680,1641,11127,1216
1600000US0684550,0684550,"Westminster city, California",28876,1858,14902,1592,13974,1622
1600000US0685292,0685292,"Whittier city, California",26722,1431,15832,1394,10890,1233
1600000US0686832,0686832,"Yorba Linda city, California",22410,1190,18494,1408,3916,836
1600000US0686972,0686972,"Yuba City city, California",22172,1194,12341,1106,9831,1116
1600000US0803455,0803455,"Arvada city, Colorado",47083,1489,35818,1721,11265,1310
1600000US0804000,0804000,"Aurora city, Colorado",128100,3000,77591,3420,50509,2782
1600000US0807850,0807850,"Boulder city, Colorado",42177,1737,19137,1465,23040,1714
1600000US0809280,0809280,"Broomfield city, Colorado",27665,629,18573,869,9092,886
1600000US0812815,0812815,"Centennial city, Colorado",40480,1504,32265,1411,8215,1086
1600000US0816000,0816000,"Colorado Springs city, Colorado",181677,2622,104939,3271,76738,3060
1600000US0820000,0820000,"Denver city, Colorado",296938,2993,148568,4262,148370,4839
1600000US0827425,0827425,"Fort Collins city, Colorado",60376,2411,32215,2017,28161,2010
1600000US0832155,0832155,"Greeley city, Colorado",36963,1458,22256,1763,14707,1550
1600000US0836410,0836410,"Highlands Ranch CDP, Colorado",38313,1568,30351,1465,7962,1267
1600000US0843000,0843000,"Lakewood city, Colorado",64260,2267,37773,2248,26487,1972
1600000US0845970,0845970,"Longmont city, Colorado",37073,1803,22042,1752,15031,1789
1600000US0846465,0846465,"Loveland city, Colorado",33384,1637,22267,1702,11117,1671
1600000US0862000,0862000,"Pueblo city, Colorado",44459,1398,24724,1744,19735,1754
1600000US0877290,0877290,"Thornton city, Colorado",45908,2128,33983,2390,11925,1515
1600000US0883835,0883835,"Westminster city, Colorado",45750,2154,29031,1916,16719,1442
1600000US0908000,0908000,"Bridgeport city, Connecticut",48023,2060,21868,1938,26155,1888
1600000US0918430,0918430,"Danbury city, Connecticut",30963,1915,17929,1991,13034,1518
1600000US0937000,0937000,"Hartford city, Connecticut",42395,2050,10200,971,32195,2050
1600000US0950370,0950370,"New Britain city, Connecticut",28305,1524,11725,1385,16580,1449
1600000US0952000,0952000,"New Haven city, Connecticut",47579,2649,13692,1741,33887,2522
1600000US0955990,0955990,"Norwalk city, Connecticut",33535,1885,17294,1721,16241,1674
1600000US0973000,0973000,"Stamford city, Connecticut",51254,2539,27309,2148,23945,2310
1600000US0980000,0980000,"Waterbury city, Connecticut",39869,2408,17664,1478,22205,2298
1600000US1077580,1077580,"Wilmington city, Delaware",30272,1893,13263,1569,17009,1598
1600000US1150000,1150000,"Washington city, District of Columbia",281475,3302,118805,3235,162670,3861
1600000US1200410,1200410,"Alafaya CDP, Florida",28252,3141,19587,2866,8665,2152
1600000US1207300,1207300,"Boca Raton city, Florida",40455,2254,30719,2049,9736,1540
1600000US1207875,1207875,"Boynton Beach city, Florida",27522,2540,16375,2001,11147,1498
1600000US1208150,1208150,"Brandon CDP, Florida",42544,2618,21543,2119,21001,2017
1600000US1210275,1210275,"Cape Coral city, Florida",66046,3550,49008,3428,17038,2058
1600000US1212875,1212875,"Clearwater city, Florida",45734,1906,25343,1879,20391,1922
1600000US1214400,1214400,"Coral Springs city, Florida",41195,1947,25582,1777,15613,1854
1600000US1216475,1216475,"Davie town, Florida",34885,2077,24524,2220,10361,1419
1600000US1216525,1216525,"Daytona Beach city, Florida",27042,2194,12043,1705,14999,1686
1600000US1216725,1216725,"Deerfield Beach city, Florida",30853,2332,17398,1870,13455,1750
1600000US1217100,1217100,"Delray Beach city, Florida",27750,1870,16519,1609,11231,1400
1600000US1217200,1217200,"Deltona city, Florida",30261,1664,20831,2152,9430,1614
1600000US1224000,1224000,"Fort Lauderdale city, Florida",69899,3792,36209,2875,33690,2678
1600000US1224125,1224125,"Fort Myers city, Florida",29430,2251,13927,1752,15503,1792
1600000US1225175,1225175,"Gainesville city, Florida",51104,2561,20478,1897,30626,2310
1600000US1230000,1230000,"Hialeah city, Florida",77399,3387,34931,2421,42468,2719
1600000US1232000,1232000,"Hollywood city, Florida",54454,2552,30739,2146,23715,2307
1600000US1232275,1232275,"Homestead city, Florida",18279,1475,7995,1448,10284,1442
1600000US1235000,1235000,"Jacksonville city, Florida",338564,3480,185210,5239,153354,5434
1600000US1236100,1236100,"Kendall CDP, Florida",26139,2018,16794,1714,9345,1790
1600000US1236950,1236950,"Kissimmee city, Florida",22086,2246,8274,1291,13812,1893
1600000US1238250,1238250,"Lakeland city, Florida",41134,2070,22365,1791,18769,2137
1600000US1239425,1239425,"Largo city, Florida",36735,2277,21513,1953,15222,1581
1600000US1239550,1239550,"Lauderhill city, Florida",22167,1774,11073,1422,11094,1554
1600000US1239925,1239925,"Lehigh Acres CDP, Florida",33814,2118,20003,1881,13811,1753
1600000US1243975,1243975,"Melbourne city, Florida",32258,2893,19998,2380,12260,1740
1600000US1245000,1245000,"Miami city, Florida",170005,4590,49202,3706,120803,4823
1600000US1245025,1245025,"Miami Beach city, Florida",43959,2264,15641,1512,28318,2168
1600000US1245060,1245060,"Miami Gardens city, Florida",27517,1933,17892,1540,9625,1443
1600000US1245975,1245975,"Miramar city, Florida",41430,2630,27668,2408,13762,2117
1600000US1249675,1249675,"North Port city, Florida",23269,2371,16990,2633,6279,1944
1600000US1253000,1253000,"Orlando city, Florida",107590,3673,35916,2467,71674,3380
1600000US1254000,1254000,"Palm Bay city, Florida",38707,2493,26508,2678,12199,1862
1600000US1254200,1254200,"Palm Coast city, Florida",32334,1818,24241,1768,8093,1368
1600000US1255775,1255775,"Pembroke Pines city, Florida",56680,2415,38977,2372,17703,2265
1600000US1256825,1256825,"Pine Hills CDP, Florida",22092,2160,9880,1499,12212,1929
1600000US1257425,1257425,"Plantation city, Florida",33537,1944,21149,2158,12388,1508
1600000US1257900,1257900,"Poinciana CDP, Florida",18418,2044,13927,2002,4491,1604
1600000US1258050,1258050,"Pompano Beach city, Florida",42621,2253,22739,2078,19882,1676
1600000US1258350,1258350,"Port Charlotte CDP, Florida",24643,1961,18233,1736,6410,1230
1600000US1258715,1258715,"Port St. Lucie city, Florida",65514,2944,48372,3531,17142,2516
1600000US1260950,1260950,"Riverview CDP, Florida",30875,2560,22540,2113,8335,1714
1600000US1263000,1263000,"St. Petersburg city, Florida",109834,3550,66960,3213,42874,2790
1600000US1268350,1268350,"Spring Hill CDP, Florida",42390,1943,31455,2066,10935,1610
1600000US1269700,1269700,"Sunrise city, Florida",30548,2040,21565,2136,8983,1422
1600000US1270600,1270600,"Tallahassee city, Florida",77176,2507,33215,2305,43961,3017
1600000US1270675,1270675,"Tamarac city, Florida",27783,2143,20763,2230,7020,1365
1600000US1271000,1271000,"Tampa city, Florida",154040,3508,71937,3504,82103,4192
1600000US1271569,1271569,"The Hammocks CDP, Florida",18228,1901,10185,1370,8043,1560
1600000US1271625,1271625,"The Villages CDP, Florida",43901,2214,42879,2236,1022,467
1600000US1272145,1272145,"Town 'n' Country CDP, Florida",32168,2306,18292,1833,13876,2138
1600000US1276582,1276582,"Weston city, Florida",22246,1347,16865,1398,5381,1390
1600000US1276600,1276600,"West Palm Beach city, Florida",39657,2382,20360,1988,19297,1502
1600000US1301052,1301052,"Albany city, Georgia",28147,1565,10761,1368,17386,1707
1600000US1301696,1301696,"Alpharetta city, Georgia",23696,1645,16586,1648,7110,1443
1600000US1303440,1303440,"Athens-Clarke County unified government (balance), Georgia",47821,1619,19004,1283,28817,1836
1600000US1304000,1304000,"Atlanta city, Georgia",199717,5434,87435,3809,112282,4476
1600000US1304204,1304204,"Augusta-Richmond County consolidated government (balance), Georgia",69283,2575,35927,2355,33356,2592
1600000US1319000,1319000,"Columbus city, Georgia",70306,1831,33412,1970,36894,2391
1600000US1342425,1342425,"Johns Creek city, Georgia",29623,1443,21869,1651,7754,1438
1600000US1349008,1349008,"Macon-Bibb County, Georgia",56151,1765,30138,1815,26013,2143
1600000US1367284,1367284,"Roswell city, Georgia",34784,1861,22116,2031,12668,1596
1600000US1368516,1368516,"Sandy Springs city, Georgia",47371,2384,21126,1953,26245,2237
1600000US1369000,1369000,"Savannah city, Georgia",53703,2491,23471,2149,30232,2572
1600000US1380508,1380508,"Warner Robins city, Georgia",29658,1901,16529,2226,13129,2045
1600000US1571550,1571550,"Urban Honolulu CDP, Hawaii",129548,3106,58465,2738,71083,3428
1600000US1608830,1608830,"Boise City city, Idaho",89803,2773,54153,2686,35650,2179
1600000US1652120,1652120,"Meridian city, Idaho",35323,2766,26833,2655,8490,2094
1600000US1656260,1656260,"Nampa city, Idaho",33258,1676,18629,2007,14629,1969
1600000US1702154,1702154,"Arlington Heights village, Illinois",30984,1685,22615,1531,8369,1326
1600000US1703012,1703012,"Aurora city, Illinois",67111,2324,45091,2845,22020,1966
1600000US1706613,1706613,"Bloomington city, Illinois",32145,1369,20176,1641,11969,1508
1600000US1707133,1707133,"Bolingbrook village, Illinois",21994,1194,17628,1313,4366,1091
1600000US1712385,1712385,"Champaign city, Illinois",35590,2160,14168,1553,21422,1901
1600000US1714000,1714000,"Chicago city, Illinois",1047695,10142,470265,9521,577430,9824
1600000US1714351,1714351,"Cicero town, Illinois",22600,1396,11452,1200,11148,1393
1600000US1718823,1718823,"Decatur city, Illinois",28341,1337,19043,1317,9298,1272
1600000US1723074,1723074,"Elgin city, Illinois",37195,2233,26204,1893,10991,1933
1600000US1724582,1724582,"Evanston city, Illinois",27760,1764,15401,1396,12359,1522
1600000US1738570,1738570,"Joliet city, Illinois",46721,2279,33214,2596,13507,1403
1600000US1751622,1751622,"Naperville city, Illinois",50008,1678,39128,1948,10880,1484
1600000US1757225,1757225,"Palatine village, Illinois",27190,1671,18269,1862,8921,1382
1600000US1759000,1759000,"Peoria city, Illinois",45862,2239,27366,1996,18496,1893
1600000US1765000,1765000,"Rockford city, Illinois",59068,1731,33168,1911,25900,1493
1600000US1768003,1768003,"Schaumburg village, Illinois",29898,1404,19762,1214,10136,1186
1600000US1770122,1770122,"Skokie village, Illinois",22323,1712,14681,1787,7642,1336
1600000US1772000,1772000,"Springfield city, Illinois",51116,1622,32444,1673,18672,1781
1600000US1779293,1779293,"Waukegan city, Illinois",29913,1786,14382,1587,15531,1707
1600000US1805860,1805860,"Bloomington city, Indiana",32643,1817,11151,1349,21492,1862
1600000US1810342,1810342,"Carmel city, Indiana",34928,1495,26132,1362,8796,1343
1600000US1822000,1822000,"Evansville city, Indiana",52799,1736,30154,1925,22645,2070
1600000US1823278,1823278,"Fishers city, Indiana",32159,1775,26384,1814,5775,1261
1600000US1825000,1825000,"Fort Wayne city, Indiana",101062,2414,61099,2475,39963,2445
1600000US1827000,1827000,"Gary city, Indiana",29978,1731,16445,1418,13533,1649
1600000US1831000,1831000,"Hammond city, Indiana",26914,1632,14787,1486,12127,1608
1600000US1836003,1836003,"Indianapolis city (balance), Indiana",334101,3914,178740,4851,155361,5447
1600000US1840788,1840788,"Lafayette city, Indiana",30593,1598,16034,1598,14559,1500
1600000US1851876,1851876,"Muncie city, Indiana",27760,1731,12320,1176,15440,1657
1600000US1871000,1871000,"South Bend city, Indiana",36161,1610,20438,1589,15723,1340
1600000US1901855,1901855,"Ames city, Iowa",25877,1268,10795,954,15082,1468
1600000US1912000,1912000,"Cedar Rapids city, Iowa",54284,1573,38394,1801,15890,1608
1600000US1919000,1919000,"Davenport city, Iowa",38402,1609,25067,1624,13335,1589
1600000US1921000,1921000,"Des Moines city, Iowa",84654,2468,51613,2705,33041,2196
1600000US1938595,1938595,"Iowa City city, Iowa",30418,1770,15102,1256,15316,1735
1600000US1973335,1973335,"Sioux City city, Iowa",31176,1336,19349,1314,11827,1317
1600000US1982425,1982425,"Waterloo city, Iowa",28449,1192,16873,1400,11576,1266
1600000US2036000,2036000,"Kansas City city, Kansas",56677,1467,31000,1619,25677,1796
1600000US2038900,2038900,"Lawrence city, Kansas",38591,1658,17156,1710,21435,2094
1600000US2052575,2052575,"Olathe city, Kansas",48080,1993,35200,1701,12880,1389
1600000US2053775,2053775,"Overland Park city, Kansas",78536,2256,48720,2266,29816,2009
1600000US2064500,2064500,"Shawnee city, Kansas",25238,1411,18820,1299,6418,1360
1600000US2071000,2071000,"Topeka city, Kansas",54707,1632,30573,1733,24134,1900
1600000US2079000,2079000,"Wichita city, Kansas",152691,2928,89426,2795,63265,3154
1600000US2108902,2108902,"Bowling Green city, Kentucky",24927,1444,9301,1129,15626,1497
1600000US2146027,2146027,"Lexington-Fayette urban county, Kentucky",129140,2283,71467,2517,57673,2442
1600000US2148006,2148006,"Louisville/Jefferson County metro government (balance), Kentucky",246707,3282,147250,4161,99457,4435
1600000US2205000,2205000,"Baton Rouge city, Louisiana",82571,2785,40422,2448,42149,2612
1600000US2208920,2208920,"Bossier City city, Louisiana",27511,1745,15137,1694,12374,1854
1600000US2239475,2239475,"Kenner city, Louisiana",23906,1693,13834,1459,10072,1322
1600000US2240735,2240735,"Lafayette city, Louisiana",48712,2603,27350,2210,21362,2192
1600000US2241155,2241155,"Lake Charles city, Louisiana",34153,1686,19437,1775,14716,1944
1600000US2250115,2250115,"Metairie CDP, Louisiana",60505,2340,37554,2031,22951,2073
1600000US2255000,2255000,"New Orleans city, Louisiana",154560,2853,72919,2065,81641,2817
1600000US2270000,2270000,"Shreveport city, Louisiana",74614,2704,36463,2535,38151,2832
1600000US2360545,2360545,"Portland city, Maine",29722,1644,14012,1320,15710,1546
1600000US2404000,2404000,"Baltimore city, Maryland",240280,3634,113940,3949,126340,4105
1600000US2407125,2407125,"Bethesda CDP, Maryland",26677,1356,17384,1219,9293,1018
1600000US2419125,2419125,"Columbia CDP, Maryland",40499,1926,27075,1703,13424,1734
1600000US2426000,2426000,"Ellicott City CDP, Maryland",25874,1668,20168,1563,5706,1177
1600000US2430325,2430325,"Frederick city, Maryland",28966,1523,16844,1616,12122,1638
1600000US2431175,2431175,"Gaithersburg city, Maryland",24459,1332,12086,1291,12373,1144
1600000US2432025,2432025,"Germantown CDP, Maryland",31593,2093,19866,1984,11727,1622
1600000US2432650,2432650,"Glen Burnie CDP, Maryland",26768,2351,16620,1860,10148,1850
1600000US2467675,2467675,"Rockville city, Maryland",25621,1425,14010,1363,11611,1170
1600000US2472450,2472450,"Silver Spring CDP, Maryland",31911,2303,12209,1440,19702,1761
1600000US2481175,2481175,"Waldorf CDP, Maryland",26092,1785,17667,1720,8425,1511
1600000US2507000,2507000,"Boston city, Massachusetts",268304,3495,94414,3750,173890,4043
1600000US2509000,2509000,"Brockton city, Massachusetts",33258,1542,18238,1641,15020,1815
1600000US2511000,2511000,"Cambridge city, Massachusetts",45177,2046,16111,1573,29066,1988
1600000US2523000,2523000,"Fall River city, Massachusetts",38261,1916,13648,1616,24613,1938
1600000US2524960,2524960,"Framingham CDP, Massachusetts",26026,2016,14407,1568,11619,1602
1600000US2534550,2534550,"Lawrence city, Massachusetts",25836,1509,6741,1013,19095,1743
1600000US2537000,2537000,"Lowell city, Massachusetts",39016,2582,16403,1740,22613,2080
1600000US2537490,2537490,"Lynn city, Massachusetts",33654,2034,15354,1642,18300,1603
1600000US2545000,2545000,"New Bedford city, Massachusetts",39377,1628,15221,1177,24156,1696
1600000US2545560,2545560,"Newton city, Massachusetts",31504,1180,22920,1451,8584,1358
1600000US2555745,2555745,"Quincy city, Massachusetts",38420,2222,19065,1713,19355,2177
1600000US2562535,2562535,"Somerville city, Massachusetts",34271,1792,11777,1654,22494,2101
1600000US2567000,2567000,"Springfield city, Massachusetts",57158,2543,25133,2219,32025,2331
1600000US2582000,2582000,"Worcester city, Massachusetts",72067,2381,28011,2116,44056,2466
1600000US2603000,2603000,"Ann Arbor city, Michigan",46946,1806,22283,1580,24663,1651
1600000US2621000,2621000,"Dearborn city, Michigan",29913,1540,19715,1556,10198,1289
1600000US2622000,2622000,"Detroit city, Michigan",264360,4612,124096,4365,140264,4723
1600000US2627440,2627440,"Farmington Hills city, Michigan",34069,1596,21175,1388,12894,1372
1600000US2629000,2629000,"Flint city, Michigan",41302,2026,24552,1886,16750,1812
1600000US2634000,2634000,"Grand Rapids city, Michigan",74169,2473,42147,2329,32022,2236
1600000US2642160,2642160,"Kalamazoo city, Michigan",29325,1600,13765,1177,15560,1726
1600000US2646000,2646000,"Lansing city, Michigan",48190,1593,23948,1386,24242,2075
1600000US2649000,2649000,"Livonia city, Michigan",36593,1353,31973,1394,4620,737
1600000US2669035,2669035,"Rochester Hills city, Michigan",29118,1154,23536,1384,5582,856
1600000US2674900,2674900,"Southfield city, Michigan",30093,1606,14360,1249,15733,1491
1600000US2676460,2676460,"Sterling Heights city, Michigan",49939,1790,35314,2048,14625,1685
1600000US2680700,2680700,"Troy city, Michigan",31954,1344,23044,1357,8910,1116
1600000US2684000,2684000,"Warren city, Michigan",54699,1846,37339,2326,17360,1914
1600000US2686000,2686000,"Westland city, Michigan",35914,1665,21985,1667,13929,1468
1600000US2688940,2688940,"Wyoming city, Michigan",28330,1702,19588,1683,8742,1357
1600000US2706616,2706616,"Bloomington city, Minnesota",36455,1946,24862,1785,11593,1334
1600000US2707966,2707966,"Brooklyn Park city, Minnesota",27849,1728,19995,1514,7854,1443
1600000US2717000,2717000,"Duluth city, Minnesota",34939,1406,20671,1283,14268,1345
1600000US2717288,2717288,"Eagan city, Minnesota",26342,1077,18019,1144,8323,1054
1600000US2740166,2740166,"Maple Grove city, Minnesota",26289,1214,22166,1219,4123,734
1600000US2743000,2743000,"Minneapolis city, Minnesota",176416,3659,83829,2924,92587,3377
1600000US2751730,2751730,"Plymouth city, Minnesota",31135,1432,22729,1539,8406,1333
1600000US2754880,2754880,"Rochester city, Minnesota",46645,1338,31637,1343,15008,1171
1600000US2756896,2756896,"St. Cloud city, Minnesota",26416,1411,14409,1140,12007,1405
1600000US2758000,2758000,"St. Paul city, Minnesota",112467,2566,54846,2518,57621,2945
1600000US2771428,2771428,"Woodbury city, Minnesota",24363,1194,19804,1316,4559,932
1600000US2829700,2829700,"Gulfport city, Mississippi",28157,1736,14290,1502,13867,1715
1600000US2836000,2836000,"Jackson city, Mississippi",61957,2197,30568,1839,31389,2145
1600000US2915670,2915670,"Columbia city, Missouri",47678,2195,22021,2078,25657,2512
1600000US2935000,2935000,"Independence city, Missouri",45560,2132,27056,1931,18504,1928
1600000US2938000,2938000,"Kansas City city, Missouri",204678,3655,110070,3227,94608,3544
1600000US2941348,2941348,"Lee's Summit city, Missouri",36237,1651,27141,1475,9096,1381
1600000US2954074,2954074,"O'Fallon city, Missouri",30224,1340,25637,1745,4587,1066
1600000US2964082,2964082,"St. Charles city, Missouri",28324,2080,17953,1601,10371,1341
1600000US2964550,2964550,"St. Joseph city, Missouri",28999,1555,17081,1247,11918,1271
1600000US2965000,2965000,"St. Louis city, Missouri",138513,2993,60483,2956,78030,2974
1600000US2970000,2970000,"Springfield city, Missouri",73568,2282,32127,2052,41441,2775
1600000US3006550,3006550,"Billings city, Montana",46642,1698,29576,1964,17066,1953
1600000US3050200,3050200,"Missoula city, Montana",31756,1434,14042,1261,17714,1766
1600000US3128000,3128000,"Lincoln city, Nebraska",111610,1859,65605,2214,46005,2485
1600000US3137000,3137000,"Omaha city, Nebraska",184938,2157,104986,3000,79952,3164
1600000US3223770,3223770,"Enterprise CDP, Nevada",53703,2947,32595,2636,21108,1886
1600000US3231900,3231900,"Henderson city, Nevada",116407,3038,74794,2979,41613,2559
1600000US3240000,3240000,"Las Vegas city, Nevada",233581,4902,121087,4459,112494,4361
1600000US3251800,3251800,"North Las Vegas city, Nevada",72620,2540,43238,2659,29382,2429
1600000US3254600,3254600,"Paradise CDP, Nevada",92035,4069,36220,2164,55815,3839
1600000US3260600,3260600,"Reno city, Nevada",100794,2516,48937,2554,51857,2385
1600000US3268400,3268400,"Sparks city, Nevada",39746,1778,21726,1884,18020,1776
1600000US3268585,3268585,"Spring Valley CDP, Nevada",76916,3139,38745,2308,38171,2680
1600000US3271400,3271400,"Sunrise Manor CDP, Nevada",62884,2586,33365,2180,29519,2087
1600000US3345140,3345140,"Manchester city, New Hampshire",46172,1913,18702,1803,27470,1908
1600000US3350260,3350260,"Nashua city, New Hampshire",36257,1734,19594,1438,16663,1652
1600000US3403580,3403580,"Bayonne city, New Jersey",26487,1712,9656,1400,16831,1580
1600000US3410000,3410000,"Camden city, New Jersey",26292,1852,10407,1470,15885,1493
1600000US3413690,3413690,"Clifton city, New Jersey",29740,1796,16523,1507,13217,1766
1600000US3419390,3419390,"East Orange city, New Jersey",22871,1658,5552,955,17319,1586
1600000US3421000,3421000,"Elizabeth city, New Jersey",40273,1922,8720,1234,31553,1901
1600000US3436000,3436000,"Jersey City city, New Jersey",99363,2727,30970,2428,68393,3077
1600000US3451000,3451000,"Newark city, New Jersey",98678,2980,24896,2091,73782,3371
1600000US3456550,3456550,"Passaic city, New Jersey",19890,1454,4060,920,15830,1328
1600000US3457000,3457000,"Paterson city, New Jersey",44010,1724,11688,1384,32322,2145
1600000US3473110,3473110,"Toms River CDP, New Jersey",34196,1725,26904,1721,7292,1179
1600000US3474000,3474000,"Trenton city, New Jersey",27324,1901,10212,1484,17112,1711
1600000US3474630,3474630,"Union City city, New Jersey",22927,1228,4134,759,18793,1305
1600000US3502000,3502000,"Albuquerque city, New Mexico",221418,3270,134243,3663,87175,3604
1600000US3539380,3539380,"Las Cruces city, New Mexico",39176,2198,22035,1996,17141,2076
1600000US3563460,3563460,"Rio Rancho city, New Mexico",34189,1384,25464,1722,8725,1323
1600000US3570500,3570500,"Santa Fe city, New Mexico",33767,1491,20690,1340,13077,1441
1600000US3601000,3601000,"Albany city, New York",39646,1794,14755,1433,24891,1666
1600000US3608026,3608026,"Brentwood CDP, New York",14133,1505,11050,1404,3083,769
1600000US3611000,3611000,"Buffalo city, New York",110678,3152,45323,2763,65355,2791
1600000US3615000,3615000,"Cheektowaga CDP, New York",30936,1217,21383,1571,9553,1496
1600000US3649121,3649121,"Mount Vernon city, New York",28111,1607,10471,1233,17640,1737
1600000US3650617,3650617,"New Rochelle city, New York",28514,1967,16764,1514,11750,1615
1600000US3651000,3651000,"New York city, New York",3159674,11338,1031793,12212,2127881,16154
1600000US3663000,3663000,"Rochester city, New York",90303,2894,34279,2317,56024,2495
1600000US3665508,3665508,"Schenectady city, New York",21353,1917,11199,1748,10154,1461
1600000US3673000,3673000,"Syracuse city, New York",54062,2170,19959,1464,34103,1975
1600000US3684000,3684000,"Yonkers city, New York",75981,2599,33483,2343,42498,2683
1600000US3702140,3702140,"Asheville city, North Carolina",42045,1933,21766,1748,20279,2259
1600000US3710740,3710740,"Cary town, North Carolina",62831,2258,43929,2267,18902,1709
1600000US3712000,3712000,"Charlotte city, North Carolina",331822,4253,176387,4581,155435,4426
1600000US3714100,3714100,"Concord city, North Carolina",33305,1689,23157,1918,10148,1496
1600000US3719000,3719000,"Durham city, North Carolina",110017,2128,52616,2259,57401,2576
1600000US3722920,3722920,"Fayetteville city, North Carolina",83558,2292,36909,1804,46649,2381
1600000US3725580,3725580,"Gastonia city, North Carolina",30097,1344,15732,1403,14365,1526
1600000US3728000,3728000,"Greensboro city, North Carolina",115802,3260,58249,3338,57553,3455
1600000US3728080,3728080,"Greenville city, North Carolina",36029,1857,12685,1882,23344,1920
1600000US3731400,3731400,"High Point city, North Carolina",40437,2130,23047,1808,17390,1778
1600000US3734200,3734200,"Jacksonville city, North Carolina",19630,2136,5937,1217,13693,1950
1600000US3755000,3755000,"Raleigh city, North Carolina",183672,3738,98051,3623,85621,4184
1600000US3774440,3774440,"Wilmington city, North Carolina",51862,2266,24216,1995,27646,2315
1600000US3775000,3775000,"Winston-Salem city, North Carolina",94344,2828,50294,2750,44050,2879
1600000US3807200,3807200,"Bismarck city, North Dakota",31597,1237,19901,1488,11696,1485
1600000US3825700,3825700,"Fargo city, North Dakota",54351,1786,25318,1723,29033,1862
1600000US3901000,3901000,"Akron city, Ohio",84331,2652,43318,2431,41013,2728
1600000US3912000,3912000,"Canton city, Ohio",30708,2115,13668,1599,17040,1975
1600000US3915000,3915000,"Cincinnati city, Ohio",140911,2977,52165,2520,88746,2793
1600000US3916000,3916000,"Cleveland city, Ohio",171717,3269,69387,3021,102330,3249
1600000US3918000,3918000,"Columbus city, Ohio",355414,4641,158816,4931,196598,5655
1600000US3921000,3921000,"Dayton city, Ohio",57649,2455,25256,1760,32393,2282
1600000US3944856,3944856,"Lorain city, Ohio",26351,1353,13891,1238,12460,1457
1600000US3961000,3961000,"Parma city, Ohio",33748,1411,23645,1518,10103,1404
1600000US3977000,3977000,"Toledo city, Ohio",117449,2406,59945,2907,57504,2794
1600000US3988000,3988000,"Youngstown city, Ohio",26746,1385,14249,1214,12497,1282
1600000US4009050,4009050,"Broken Arrow city, Oklahoma",39869,1285,29515,1182,10354,1058
1600000US4023200,4023200,"Edmond city, Oklahoma",34670,1823,22626,1741,12044,1232
1600000US4041850,4041850,"Lawton city, Oklahoma",33863,1369,15559,1341,18304,1729
1600000US4052500,4052500,"Norman city, Oklahoma",48236,2115,23705,1900,24531,2232
1600000US4055000,4055000,"Oklahoma City city, Oklahoma",237932,3351,141657,3221,96275,3459
1600000US4075000,4075000,"Tulsa city, Oklahoma",162640,2414,83250,2214,79390,2668
1600000US4105350,4105350,"Beaverton city, Oregon",39301,1631,19605,1481,19696,1774
1600000US4105800,4105800,"Bend city, Oregon",37831,1674,22461,2235,15370,2205
1600000US4123850,4123850,"Eugene city, Oregon",70253,1955,34244,2055,36009,2302
1600000US4131250,4131250,"Gresham city, Oregon",40669,2170,23602,1776,17067,1974
1600000US4134100,4134100,"Hillsboro city, Oregon",38749,2189,21365,2109,17384,1580
1600000US4147000,4147000,"Medford city, Oregon",32615,1506,17935,1612,14680,1469
1600000US4159000,4159000,"Portland city, Oregon",265700,3566,142543,3820,123157,4037
1600000US4164900,4164900,"Salem city, Oregon",58511,2236,32278,2171,26233,2357
1600000US4202000,4202000,"Allentown city, Pennsylvania",43480,1805,17308,1693,26172,2037
1600000US4206088,4206088,"Bethlehem city, Pennsylvania",27995,1994,14364,1482,13631,1692
1600000US4224000,4224000,"Erie city, Pennsylvania",38522,1542,19535,1818,18987,1688
1600000US4260000,4260000,"Philadelphia city, Pennsylvania",606142,4673,296863,6050,309279,6790
1600000US4261000,4261000,"Pittsburgh city, Pennsylvania",137442,3392,67219,2714,70223,3345
1600000US4263624,4263624,"Reading city, Pennsylvania",28765,1646,11473,1481,17292,1554
1600000US4269000,4269000,"Scranton city, Pennsylvania",31486,1998,14210,1451,17276,1780
1600000US4419180,4419180,"Cranston city, Rhode Island",28764,1878,20132,1407,8632,1302
1600000US4454640,4454640,"Pawtucket city, Rhode Island",27548,1912,12005,1274,15543,1762
1600000US4459000,4459000,"Providence city, Rhode Island",64156,3046,25008,2289,39148,3520
1600000US4474300,4474300,"Warwick city, Rhode Island",33749,1394,24893,1473,8856,1300
1600000US4513330,4513330,"Charleston city, South Carolina",56780,2637,32141,2640,24639,2515
1600000US4516000,4516000,"Columbia city, South Carolina",48202,2250,21252,1761,26950,1961
1600000US4530850,4530850,"Greenville city, South Carolina",31367,1465,13569,1272,17798,1606
1600000US4548535,4548535,"Mount Pleasant town, South Carolina",34298,1994,25146,1857,9152,1493
1600000US4550875,4550875,"North Charleston city, South Carolina",45072,2552,19237,1959,25835,2176
1600000US4561405,4561405,"Rock Hill city, South Carolina",28673,1774,16399,1543,12274,1349
1600000US4652980,4652980,"Rapid City city, South Dakota",29814,1355,16486,1321,13328,1321
1600000US4659020,4659020,"Sioux Falls city, South Dakota",72873,1745,45700,1961,27173,2044
1600000US4714000,4714000,"Chattanooga city, Tennessee",75985,2388,37586,2164,38399,2354
1600000US4715160,4715160,"Clarksville city, Tennessee",56014,2149,29134,1983,26880,2303
1600000US4727740,4727740,"Franklin city, Tennessee",30018,1246,21328,1493,8690,1318
1600000US4737640,4737640,"Jackson city, Tennessee",24077,1441,12096,1331,11981,1575
1600000US4738320,4738320,"Johnson City city, Tennessee",27768,2172,13899,1536,13869,1850
1600000US4740000,4740000,"Knoxville city, Tennessee",79066,2556,36057,2346,43009,2150
1600000US4748000,4748000,"Memphis city, Tennessee",246518,4056,113341,3325,133177,4394
1600000US4751560,4751560,"Murfreesboro city, Tennessee",48694,1767,25452,1996,23242,2125
1600000US4752006,4752006,"Nashville-Davidson metropolitan government (balance), Tennessee",273111,3958,143523,4382,129588,4644
1600000US4801000,4801000,"Abilene city, Texas",42828,1679,24859,1345,17969,1689
1600000US4801924,4801924,"Allen city, Texas",33446,1838,25731,2011,7715,1513
1600000US4803000,4803000,"Amarillo city, Texas",76092,2092,45721,2414,30371,2186
1600000US4804000,4804000,"Arlington city, Texas",131485,3654,73066,3449,58419,3558
1600000US4804462,4804462,"Atascocita CDP, Texas",25319,2159,21695,1959,3624,1653
1600000US4805000,4805000,"Austin city, Texas",376509,6217,169291,5019,207218,7243
1600000US4806128,4806128,"Baytown city, Texas",27188,2232,16166,1710,11022,1718
1600000US4807000,4807000,"Beaumont city, Texas",44960,2389,25889,2221,19071,2140
1600000US4810768,4810768,"Brownsville city, Texas",52138,2207,31010,2251,21128,2034
1600000US4810912,4810912,"Bryan city, Texas",30998,1630,15580,1617,15418,1611
1600000US4813024,4813024,"Carrollton city, Texas",47064,1905,28026,1530,19038,1810
1600000US4813552,4813552,"Cedar Park city, Texas",22376,1540,15386,1378,6990,1036
1600000US4815976,4815976,"College Station city, Texas",38829,2043,14691,1676,24138,2241
1600000US4816432,4816432,"Conroe city, Texas",29297,2333,16439,1835,12858,1763
1600000US4817000,4817000,"Corpus Christi city, Texas",115797,2373,65707,3247,50090,3165
1600000US4819000,4819000,"Dallas city, Texas",513084,5613,202101,5335,310983,6324
1600000US4819972,4819972,"Denton city, Texas",49287,2694,23736,1749,25551,2429
1600000US4822660,4822660,"Edinburg city, Texas",26185,1936,13896,1943,12289,1879
1600000US4824000,4824000,"El Paso city, Texas",229156,2764,134920,3913,94236,4181
1600000US4826232,4826232,"Flower Mound town, Texas",25597,1270,22757,1576,2840,794
1600000US4827000,4827000,"Fort Worth city, Texas",299593,4906,169775,4713,129818,5070
1600000US4827684,4827684,"Frisco city, Texas",58409,2086,42259,1805,16150,2153
1600000US4829000,4829000,"Garland city, Texas",77072,2437,48622,2506,28450,2284
1600000US4829336,4829336,"Georgetown city, Texas",26361,2004,18489,1925,7872,1263
1600000US4830464,4830464,"Grand Prairie city, Texas",60843,2632,38663,2726,22180,2289
1600000US4832372,4832372,"Harlingen city, Texas",19945,1374,10859,1407,9086,1234
1600000US4835000,4835000,"Houston city, Texas",837686,10337,358277,7235,479409,10011
1600000US4837000,4837000,"Irving city, Texas",84371,3100,31985,1897,52386,3127
1600000US4839148,4839148,"Killeen city, Texas",53350,2227,23417,2530,29933,2479
1600000US4841464,4841464,"Laredo city, Texas",70522,1816,42635,2478,27887,2415
1600000US4841980,4841980,"League City city, Texas",35854,1910,26921,2022,8933,1671
1600000US4842508,4842508,"Lewisville city, Texas",39357,1818,15716,1578,23641,1816
1600000US4843888,4843888,"Longview city, Texas",29620,1733,16417,1644,13203,1715
1600000US4845000,4845000,"Lubbock city, Texas",94480,2750,46992,2373,47488,3025
1600000US4845384,4845384,"McAllen city, Texas",46598,2236,27601,2349,18997,2485
1600000US4845744,4845744,"McKinney city, Texas",61833,2257,39616,2301,22217,2484
1600000US4846452,4846452,"Mansfield city, Texas",22679,1511,17346,1572,5333,1319
1600000US4847892,4847892,"Mesquite city, Texas",44948,2431,27274,2076,17674,2002
1600000US4848072,4848072,"Midland city, Texas",48729,1558,32507,2096,16222,2041
1600000US4848768,4848768,"Mission city, Texas",25857,1633,17700,1924,8157,1506
1600000US4848804,4848804,"Missouri City city, Texas",23948,1943,19534,1926,4414,1383
1600000US4850820,4850820,"New Braunfels city, Texas",29931,1787,18847,1686,11084,1435
1600000US4852356,4852356,"North Richland Hills city, Texas",27650,1686,17966,1541,9684,1600
1600000US4853388,4853388,"Odessa city, Texas",39400,1774,23314,1825,16086,1872
1600000US4856000,4856000,"Pasadena city, Texas",47532,2223,25534,1996,21998,2029
1600000US4856348,4856348,"Pearland city, Texas",42672,2274,31840,2197,10832,2200
1600000US4857200,4857200,"Pharr city, Texas",22897,1618,13769,1618,9128,1517
1600000US4858016,4858016,"Plano city, Texas",106078,3217,62917,2673,43161,2841
1600000US4861796,4861796,"Richardson city, Texas",43017,2577,24536,2047,18481,1782
1600000US4863500,4863500,"Round Rock city, Texas",38368,2070,23860,1953,14508,2092
1600000US4864472,4864472,"San Angelo city, Texas",35383,1733,21372,1584,14011,1658
1600000US4865000,4865000,"San Antonio city, Texas",501645,5428,274970,6133,226675,6403
1600000US4870808,4870808,"Sugar Land city, Texas",29065,2138,22363,2070,6702,1398
1600000US4872176,4872176,"Temple city, Texas",27395,1778,14612,1610,12783,1344
1600000US4872656,4872656,"The Woodlands CDP, Texas",42621,2866,31973,3096,10648,2329
1600000US4874144,4874144,"Tyler city, Texas",36030,2013,20331,1746,15699,1797
1600000US4875428,4875428,"Victoria city, Texas",23876,1240,13915,1205,9961,1388
1600000US4876000,4876000,"Waco city, Texas",49706,2323,22047,1612,27659,2173
1600000US4879000,4879000,"Wichita Falls city, Texas",37535,2317,20570,1755,16965,1903
1600000US4943660,4943660,"Layton city, Utah",23579,1238,18248,1212,5331,982
1600000US4955980,4955980,"Ogden city, Utah",30058,1609,16587,1553,13471,1298
1600000US4957300,4957300,"Orem city, Utah",28262,1250,15620,1378,12642,1257
1600000US4962470,4962470,"Provo city, Utah",34962,1553,13702,1195,21260,1683
1600000US4965330,4965330,"St. George city, Utah",29352,1970,18830,1596,10522,1711
1600000US4967000,4967000,"Salt Lake City city, Utah",78086,2618,38166,2622,39920,2312
1600000US4967440,4967440,"Sandy city, Utah",31784,1642,24679,1612,7105,1603
1600000US4970850,4970850,"South Jordan city, Utah",21745,1693,18135,1677,3610,1123
1600000US4982950,4982950,"West Jordan city, Utah",32635,2187,23891,1900,8744,1772
1600000US4983470,4983470,"West Valley City city, Utah",40010,2227,27817,2067,12193,1504
1600000US5101000,5101000,"Alexandria city, Virginia",69667,1713,29630,1747,40037,2240
1600000US5103000,5103000,"Arlington CDP, Virginia",104750,2143,44982,2316,59768,2745
1600000US5114440,5114440,"Centreville CDP, Virginia",24888,1594,16994,1576,7894,1578
1600000US5116000,5116000,"Chesapeake city, Virginia",83402,2082,61061,2344,22341,2176
1600000US5121088,5121088,"Dale City CDP, Virginia",20525,1817,16853,1621,3672,935
1600000US5135000,5135000,"Hampton city, Virginia",53267,1436,29238,1868,24029,1709
1600000US5147672,5147672,"Lynchburg city, Virginia",27814,1456,13634,1172,14180,1475
1600000US5156000,5156000,"Newport News city, Virginia",69249,2154,34539,2037,34710,2075
1600000US5157000,5157000,"Norfolk city, Virginia",87857,2152,38208,2167,49649,2723
1600000US5164000,5164000,"Portsmouth city, Virginia",36246,1157,19614,1486,16632,1291
1600000US5167000,5167000,"Richmond city, Virginia",87401,2053,37895,1959,49506,2471
1600000US5168000,5168000,"Roanoke city, Virginia",42133,1319,21677,1909,20456,1793
1600000US5176432,5176432,"Suffolk city, Virginia",33077,1054,22122,1330,10955,1400
1600000US5182000,5182000,"Virginia Beach city, Virginia",168818,2960,108813,3223,60005,3158
1600000US5303180,5303180,"Auburn city, Washington",29701,1812,16160,1764,13541,1873
1600000US5305210,5305210,"Bellevue city, Washington",59588,2171,32721,1904,26867,2179
1600000US5305280,5305280,"Bellingham city, Washington",39465,1894,19392,1593,20073,1889
1600000US5322640,5322640,"Everett city, Washington",42895,2124,19699,1692,23196,2183
1600000US5323515,5323515,"Federal Way city, Washington",35162,1874,18656,1918,16506,1722
1600000US5335275,5335275,"Kennewick city, Washington",29353,1620,17625,1546,11728,1671
1600000US5335415,5335415,"Kent city, Washington",43906,2337,23004,2155,20902,2183
1600000US5335940,5335940,"Kirkland city, Washington",36175,1584,23085,1651,13090,1724
1600000US5343955,5343955,"Marysville city, Washington",25410,1644,17562,1731,7848,1309
1600000US5353545,5353545,"Pasco city, Washington",20628,1192,15140,1459,5488,1212
1600000US5357745,5357745,"Renton city, Washington",38103,2098,19416,1811,18687,1885
1600000US5363000,5363000,"Seattle city, Washington",329671,5082,155426,4563,174245,6065
1600000US5367000,5367000,"Spokane city, Washington",90699,2337,49400,2849,41299,2409
1600000US5367167,5367167,"Spokane Valley city, Washington",41372,1836,24539,1857,16833,1772
1600000US5370000,5370000,"Tacoma city, Washington",83034,2591,44223,2071,38811,2578
1600000US5374060,5374060,"Vancouver city, Washington",68395,1763,35598,2064,32797,2050
1600000US5380010,5380010,"Yakima city, Washington",33768,1724,17454,1611,16314,1944
1600000US5502375,5502375,"Appleton city, Wisconsin",29323,1471,20072,1132,9251,1122
1600000US5522300,5522300,"Eau Claire city, Wisconsin",27785,1260,15889,1282,11896,1148
1600000US5531000,5531000,"Green Bay city, Wisconsin",43546,1416,23836,1487,19710,1649
1600000US5539225,5539225,"Kenosha city, Wisconsin",37867,1381,20815,1685,17052,1564
1600000US5548000,5548000,"Madison city, Wisconsin",111035,2902,53293,2196,57742,2883
1600000US5553000,5553000,"Milwaukee city, Wisconsin",228054,4186,92218,3507,135836,4239
1600000US5560500,5560500,"Oshkosh city, Wisconsin",27122,1403,15351,1229,11771,1210
1600000US5566000,5566000,"Racine city, Wisconsin",30633,1359,14711,1461,15922,1348
1600000US5584250,5584250,"Waukesha city, Wisconsin",32294,1457,18992,1331,13302,1309
