GEO.id,GEO.id2,GEO.display-label,HD01_VD01,HD02_VD01,HD01_VD02,HD02_VD02,HD01_VD03,HD02_VD03
1600000US0107000,0107000,"Birmingham city, Alabama",88192,3684,42303,2740,45889,2448
1600000US0121184,0121184,"Dothan city, Alabama",25231,1080,15036,751,10195,821
1600000US0135896,0135896,"Hoover city, Alabama",31087,1775,20344,1495,10743,1486
1600000US0137000,0137000,"Huntsville city, Alabama",75912,2226,45355,1998,30557,1937
1600000US0150000,0150000,"Mobile city, Alabama",76617,2724,41767,1999,34850,2335
1600000US0151000,0151000,"Montgomery city, Alabama",81379,1837,46379,2210,35000,2376
1600000US0177256,0177256,"Tuscaloosa city, Alabama",31769,2007,15569,1518,16200,1834
1600000US0203000,0203000,"Anchorage municipality, Alaska",105569,1780,63354,2779,42215,2614
1600000US0404720,0404720,"Avondale city, Arizona",22706,1116,12719,1510,9987,1381
1600000US0410670,0410670,"Casas Adobes CDP, Arizona",28130,1455,18054,1327,10076,1186
1600000US0412000,0412000,"Chandler city, Arizona",86891,2951,53289,2429,33602,2296
1600000US0423620,0423620,"Flagstaff city, Arizona",22879,1550,10136,1251,12743,1307
1600000US0427400,0427400,"Gilbert town, Arizona",72621,2262,50499,2651,22122,2143
1600000US0427820,0427820,"Glendale city, Arizona",80385,2595,44566,2577,35819,2478
1600000US0428380,0428380,"Goodyear city, Arizona",23400,1677,16763,2001,6637,1373
1600000US0446000,0446000,"Mesa city, Arizona",167435,3848,100935,3795,66500,3093
1600000US0454050,0454050,"Peoria city, Arizona",56870,2143,39536,2183,17334,2020
1600000US0455000,0455000,"Phoenix city, Arizona",521555,6541,276136,6543,245419,6222
1600000US0464210,0464210,"San Tan Valley CDP, Arizona",24066,2188,16120,1832,7946,1787
1600000US0465000,0465000,"Scottsdale city, Arizona",100862,2901,66101,3213,34761,2395
1600000US0471510,0471510,"Surprise city, Arizona",41846,2327,31328,2508,10518,1359
1600000US0473000,0473000,"Tempe city, Arizona",64406,3052,27594,2066,36812,2496
1600000US0477000,0477000,"Tucson city, Arizona",203252,4322,100371,3709,102881,4185
1600000US0485540,0485540,"Yuma city, Arizona",33532,1685,19278,1613,14254,1506
1600000US0523290,0523290,"Fayetteville city, Arkansas",33667,2125,14166,1791,19501,2073
1600000US0524550,0524550,"Fort Smith city, Arkansas",34964,1377,18157,1614,16807,1547
1600000US0535710,0535710,"Jonesboro city, Arkansas",27626,1093,15729,1207,11897,1237
1600000US0541000,0541000,"Little Rock city, Arkansas",78823,2891,44877,2716,33946,2769
1600000US0566080,0566080,"Springdale city, Arkansas",24308,1461,12680,1421,11628,1471
1600000US0600562,0600562,"Alameda city, California",30582,1547,13736,1281,16846,1457
1600000US0600884,0600884,"Alhambra city, California",29217,1574,11761,1285,17456,1454
1600000US0602000,0602000,"Anaheim city, California",98156,3276,44315,2706,53841,2657
1600000US0602252,0602252,"Antioch city, California",33563,1593,20789,1915,12774,1400
1600000US0602364,0602364,"Apple Valley town, California",22603,1452,13651,1223,8952,1379
1600000US0602553,0602553,"Arden-Arcade CDP, California",39940,2428,17633,1543,22307,2290
1600000US0603526,0603526,"Bakersfield city, California",111053,2739,63168,2655,47885,2905
1600000US0603666,0603666,"Baldwin Park city, California",17397,943,10013,953,7384,1026
1600000US0604982,0604982,"Bellflower city, California",23680,1290,8185,952,15495,1252
1600000US0606000,0606000,"Berkeley city, California",45674,1831,19348,1317,26326,1680
1600000US0608786,0608786,"Buena Park city, California",23548,1271,13894,1441,9654,1219
1600000US0608954,0608954,"Burbank city, California",40484,1434,17498,1437,22986,1662
1600000US0610046,0610046,"Camarillo city, California",24226,1518,17465,1486,6761,1097
1600000US0611194,0611194,"Carlsbad city, California",43309,2130,25629,2545,17680,2091
1600000US0611530,0611530,"Carson city, California",24646,1295,18381,1409,6265,1074
1600000US0613014,0613014,"Chico city, California",33405,1758,14262,1516,19143,1741
1600000US0613210,0613210,"Chino city, California",22287,1578,14838,1314,7449,1227
1600000US0613214,0613214,"Chino Hills city, California",23594,1431,19464,1553,4130,1030
1600000US0613392,0613392,"Chula Vista city, California",75942,2830,45161,2783,30781,2655
1600000US0613588,0613588,"Citrus Heights city, California",33628,1464,18198,1486,15430,1329
1600000US0614218,0614218,"Clovis city, California",33177,1503,19125,1555,14052,1335
1600000US0615044,0615044,"Compton city, California",22834,1046,12881,1035,9953,1052
1600000US0616000,0616000,"Concord city, California",44634,2116,25235,2195,19399,1939
1600000US0616350,0616350,"Corona city, California",44677,2004,29587,1889,15090,1511
1600000US0616532,0616532,"Costa Mesa city, California",41997,1676,15542,1475,26455,1873
1600000US0617918,0617918,"Daly City city, California",29976,1601,16209,1363,13767,1379
1600000US0618100,0618100,"Davis city, California",24361,1418,10376,1080,13985,1223
1600000US0619766,0619766,"Downey city, California",33310,1665,16281,1799,17029,1871
1600000US0620802,0620802,"East Los Angeles CDP, California",30707,1553,9607,1113,21100,1582
1600000US0621712,0621712,"El Cajon city, California",33891,2037,12557,1437,21334,1756
1600000US0622020,0622020,"Elk Grove city, California",47747,2555,33880,2305,13867,1847
1600000US0622230,0622230,"El Monte city, California",29423,1264,11951,1323,17472,1471
1600000US0622804,0622804,"Escondido city, California",44909,2009,21119,1724,23790,1804
1600000US0623182,0623182,"Fairfield city, California",34238,1314,19694,1542,14544,1459
1600000US0624477,0624477,"Florence-Graham CDP, California",13733,1232,4564,836,9169,1042
1600000US0624638,0624638,"Folsom city, California",24967,1579,17036,1603,7931,1033
1600000US0624680,0624680,"Fontana city, California",48641,1732,32298,2084,16343,1850
1600000US0626000,0626000,"Fremont city, California",69398,2158,43989,2369,25409,1994
1600000US0627000,0627000,"Fresno city, California",162149,3174,74075,3028,88074,3352
1600000US0628000,0628000,"Fullerton city, California",44685,1732,24152,1633,20533,1639
1600000US0629000,0629000,"Garden Grove city, California",48514,1768,25686,1840,22828,1725
1600000US0630000,0630000,"Glendale city, California",68952,2159,25820,1900,43132,2466
1600000US0632548,0632548,"Hawthorne city, California",28649,1714,7138,1014,21511,1686
1600000US0633000,0633000,"Hayward city, California",45451,1709,23844,1842,21607,1714
1600000US0633182,0633182,"Hemet city, California",28354,1592,15256,1647,13098,1207
1600000US0633434,0633434,"Hesperia city, California",27082,1587,15378,1701,11704,1286
1600000US0636000,0636000,"Huntington Beach city, California",70689,2205,40518,2250,30171,1904
1600000US0636448,0636448,"Indio city, California",22504,1477,13580,1408,8924,1092
1600000US0636546,0636546,"Inglewood city, California",36292,1613,11527,1230,24765,1708
1600000US0636770,0636770,"Irvine city, California",82613,2984,37707,3195,44906,3102
1600000US0637692,0637692,"Jurupa Valley city, California",23813,1382,14787,1085,9026,1131
1600000US0639496,0639496,"Lake Forest city, California",26688,1427,19201,1754,7487,1096
1600000US0639892,0639892,"Lakewood city, California",27003,1172,19148,1298,7855,1138
1600000US0640130,0640130,"Lancaster city, California",46483,1977,27997,1626,18486,1823
1600000US0641992,0641992,"Livermore city, California",29482,1417,20346,1703,9136,1166
1600000US0643000,0643000,"Long Beach city, California",164220,3709,64711,2932,99509,3836
1600000US0644000,0644000,"Los Angeles city, California",1332587,8853,489794,7653,842793,9781
1600000US0644574,0644574,"Lynwood city, California",14759,879,6685,840,8074,876
1600000US0645484,0645484,"Manteca city, California",23010,1244,12770,1490,10240,1309
1600000US0646842,0646842,"Menifee city, California",27132,1674,20385,1809,6747,961
1600000US0646898,0646898,"Merced city, California",25497,1357,12125,1423,13372,1292
1600000US0647766,0647766,"Milpitas city, California",19646,1306,12798,1253,6848,1199
1600000US0648256,0648256,"Mission Viejo city, California",33343,1615,25711,1630,7632,1083
1600000US0648354,0648354,"Modesto city, California",69451,2274,36473,2347,32978,2381
1600000US0649270,0649270,"Moreno Valley city, California",53127,2425,30016,2577,23111,1659
1600000US0649670,0649670,"Mountain View city, California",32271,1688,11593,1188,20678,1668
1600000US0650076,0650076,"Murrieta city, California",33478,2053,22933,2290,10545,1550
1600000US0650258,0650258,"Napa city, California",28062,1156,15416,1134,12646,1293
1600000US0651182,0651182,"Newport Beach city, California",36893,1679,20112,1779,16781,1809
1600000US0652526,0652526,"Norwalk city, California",27258,1428,18388,1157,8870,1248
1600000US0653000,0653000,"Oakland city, California",156482,3228,61480,2571,95002,3246
1600000US0653322,0653322,"Oceanside city, California",58115,2555,35376,2472,22739,2053
1600000US0653896,0653896,"Ontario city, California",44699,2011,23800,1944,20899,1883
1600000US0653980,0653980,"Orange city, California",42515,1628,25284,1622,17231,1566
1600000US0654652,0654652,"Oxnard city, California",50282,1869,27837,1850,22445,1724
1600000US0655156,0655156,"Palmdale city, California",40878,1815,24300,2050,16578,1387
1600000US0655282,0655282,"Palo Alto city, California",26610,1205,15165,1353,11445,1239
1600000US0656000,0656000,"Pasadena city, California",55992,2272,23127,1912,32865,2021
1600000US0656700,0656700,"Perris city, California",15834,1016,8081,1297,7753,1179
1600000US0657456,0657456,"Pittsburg city, California",19746,1174,10849,1274,8897,1046
1600000US0657792,0657792,"Pleasanton city, California",26104,1023,17750,1220,8354,1170
1600000US0658072,0658072,"Pomona city, California",38417,1480,21097,1439,17320,1529
1600000US0659444,0659444,"Rancho Cordova city, California",24202,1474,14101,1243,10101,984
1600000US0659451,0659451,"Rancho Cucamonga city, California",52957,2002,34023,2311,18934,1963
1600000US0659920,0659920,"Redding city, California",35360,1851,18437,1601,16923,1554
1600000US0659962,0659962,"Redlands city, California",25137,1790,15576,1617,9561,1194
1600000US0660018,0660018,"Redondo Beach city, California",28628,1663,13906,1483,14722,1785
1600000US0660102,0660102,"Redwood City city, California",28871,1518,14103,1402,14768,1307
1600000US0660466,0660466,"Rialto city, California",23880,1474,14684,1457,9196,1173
1600000US0660620,0660620,"Richmond city, California",38952,2049,18580,1767,20372,1554
1600000US0662000,0662000,"Riverside city, California",91813,3178,50599,2537,41214,2863
1600000US0662938,0662938,"Roseville city, California",46372,1798,29462,1779,16910,1417
1600000US0664000,0664000,"Sacramento city, California",177325,4031,84468,3364,92857,3655
1600000US0664224,0664224,"Salinas city, California",39429,1681,16072,1618,23357,1725
1600000US0665000,0665000,"San Bernardino city, California",56187,2246,27669,1783,28518,2139
1600000US0665042,0665042,"San Buenaventura (Ventura) city, California",40725,1846,22103,1669,18622,1585
1600000US0666000,0666000,"San Diego city, California",473842,5552,221253,5587,252589,5383
1600000US0667000,0667000,"San Francisco city, California",346842,3718,124739,4592,222103,4887
1600000US0668000,0668000,"San Jose city, California",310126,4079,174216,4409,135910,4393
1600000US0668084,0668084,"San Leandro city, California",29828,1745,15651,1464,14177,1447
1600000US0668196,0668196,"San Marcos city, California",30911,1887,18700,1743,12211,1665
1600000US0668252,0668252,"San Mateo city, California",37129,1748,18503,1500,18626,1430
1600000US0668378,0668378,"San Ramon city, California",26506,1131,17844,1419,8662,1175
1600000US0669000,0669000,"Santa Ana city, California",71272,2557,31761,1914,39511,2047
1600000US0669070,0669070,"Santa Barbara city, California",34234,1849,13680,1288,20554,1609
1600000US0669084,0669084,"Santa Clara city, California",42493,1844,19866,1527,22627,1824
1600000US0669088,0669088,"Santa Clarita city, California",58774,2061,40095,1922,18679,1922
1600000US0669196,0669196,"Santa Maria city, California",26420,1610,12781,1354,13639,1349
1600000US0670000,0670000,"Santa Monica city, California",43729,2095,12994,1449,30735,2195
1600000US0670098,0670098,"Santa Rosa city, California",62825,2135,33576,2157,29249,2221
1600000US0672016,0672016,"Simi Valley city, California",42642,1662,30747,1871,11895,1348
1600000US0673080,0673080,"South Gate city, California",23460,1049,11510,1121,11950,1125
1600000US0673262,0673262,"South San Francisco city, California",21417,1410,11828,1331,9589,1272
1600000US0675000,0675000,"Stockton city, California",90754,2332,44585,2439,46169,2067
1600000US0677000,0677000,"Sunnyvale city, California",54075,2274,24562,2368,29513,1739
1600000US0678120,0678120,"Temecula city, California",29877,1446,19354,1658,10523,1300
1600000US0678582,0678582,"Thousand Oaks city, California",44979,2013,32666,1928,12313,1515
1600000US0680000,0680000,"Torrance city, California",56709,2076,32290,2165,24419,2152
1600000US0680238,0680238,"Tracy city, California",23332,1279,15270,1591,8062,1115
1600000US0680812,0680812,"Turlock city, California",23922,1472,12537,1420,11385,1263
1600000US0680854,0680854,"Tustin city, California",25315,1627,12453,1593,12862,1213
1600000US0681204,0681204,"Union City city, California",20137,1049,13293,1266,6844,1181
1600000US0681344,0681344,"Upland city, California",26452,1602,14029,1273,12423,1360
1600000US0681554,0681554,"Vacaville city, California",31090,1522,18547,1724,12543,1454
1600000US0681666,0681666,"Vallejo city, California",39666,1913,21898,1619,17768,1625
1600000US0682590,0682590,"Victorville city, California",31479,2030,19562,2058,11917,1970
1600000US0682954,0682954,"Visalia city, California",41717,1705,23721,2110,17996,1904
1600000US0682996,0682996,"Vista city, California",31892,1665,14778,1619,17114,1319
1600000US0683346,0683346,"Walnut Creek city, California",29359,1492,20174,1622,9185,1163
1600000US0684200,0684200,"West Covina city, California",29980,1204,18782,1185,11198,1197
1600000US0684550,0684550,"Westminster city, California",26057,1461,14267,1462,11790,1152
1600000US0685292,0685292,"Whittier city, California",28237,1277,16164,1162,12073,1223
1600000US0686832,0686832,"Yorba Linda city, California",21886,1085,17643,1279,4243,858
1600000US0686972,0686972,"Yuba City city, California",21338,872,11749,1092,9589,1047
1600000US0803455,0803455,"Arvada city, Colorado",45129,1781,34178,1894,10951,1475
1600000US0804000,0804000,"Aurora city, Colorado",123327,2518,69445,3056,53882,2704
1600000US0807850,0807850,"Boulder city, Colorado",41382,1535,19373,1426,22009,1712
1600000US0812815,0812815,"Centennial city, Colorado",37459,1437,30417,1440,7042,1031
1600000US0816000,0816000,"Colorado Springs city, Colorado",168699,2869,96798,2799,71901,2725
1600000US0820000,0820000,"Denver city, Colorado",270439,2772,128521,4126,141918,4479
1600000US0827425,0827425,"Fort Collins city, Colorado",58401,2239,30180,1815,28221,2046
1600000US0832155,0832155,"Greeley city, Colorado",33281,1370,18872,1272,14409,1307
1600000US0836410,0836410,"Highlands Ranch CDP, Colorado",35950,1594,29216,1482,6734,1066
1600000US0843000,0843000,"Lakewood city, Colorado",61169,2150,34425,2243,26744,2014
1600000US0845970,0845970,"Longmont city, Colorado",34325,1617,19797,1594,14528,1610
1600000US0846465,0846465,"Loveland city, Colorado",28717,1491,18886,1604,9831,1149
1600000US0862000,0862000,"Pueblo city, Colorado",42373,1535,23981,1513,18392,1609
1600000US0877290,0877290,"Thornton city, Colorado",42113,1739,28519,2044,13594,1810
1600000US0883835,0883835,"Westminster city, Colorado",42981,1396,28320,1620,14661,1428
1600000US0908000,0908000,"Bridgeport city, Connecticut",49887,2250,20543,1717,29344,2023
1600000US0918430,0918430,"Danbury city, Connecticut",29671,1429,17368,1602,12303,1657
1600000US0937000,0937000,"Hartford city, Connecticut",43345,2064,10279,960,33066,1852
1600000US0950370,0950370,"New Britain city, Connecticut",26577,1517,9908,1037,16669,1446
1600000US0952000,0952000,"New Haven city, Connecticut",51078,1965,15953,1580,35125,2045
1600000US0955990,0955990,"Norwalk city, Connecticut",34957,1771,22724,1602,12233,1294
1600000US0973000,0973000,"Stamford city, Connecticut",46599,1849,26383,1901,20216,1871
1600000US0980000,0980000,"Waterbury city, Connecticut",40992,1793,19962,1656,21030,1845
1600000US1077580,1077580,"Wilmington city, Delaware",29575,1602,14004,1229,15571,1370
1600000US1150000,1150000,"Washington city, District of Columbia",266662,3138,110681,3549,155981,4855
1600000US1200410,1200410,"Alafaya CDP, Florida",28014,2849,17397,2292,10617,2526
1600000US1207300,1207300,"Boca Raton city, Florida",33784,1730,22807,1753,10977,1155
1600000US1207875,1207875,"Boynton Beach city, Florida",29040,1898,18066,2122,10974,1528
1600000US1208150,1208150,"Brandon CDP, Florida",38602,2331,21162,1635,17440,2042
1600000US1210275,1210275,"Cape Coral city, Florida",56705,2395,37481,2511,19224,2087
1600000US1212875,1212875,"Clearwater city, Florida",46635,2168,26405,1957,20230,2192
1600000US1214400,1214400,"Coral Springs city, Florida",39177,2045,25969,1869,13208,1344
1600000US1216475,1216475,"Davie town, Florida",31635,1615,22710,1534,8925,1411
1600000US1216725,1216725,"Deerfield Beach city, Florida",32625,2331,21559,1822,11066,1926
1600000US1217200,1217200,"Deltona city, Florida",29506,1760,23143,1929,6363,1508
1600000US1224000,1224000,"Fort Lauderdale city, Florida",69262,3233,36945,3313,32317,2167
1600000US1224125,1224125,"Fort Myers city, Florida",26600,1933,12811,1406,13789,1621
1600000US1225175,1225175,"Gainesville city, Florida",44559,2554,16674,1785,27885,2431
1600000US1230000,1230000,"Hialeah city, Florida",69816,2373,32578,2093,37238,2025
1600000US1232000,1232000,"Hollywood city, Florida",57364,2245,34181,2284,23183,2021
1600000US1235000,1235000,"Jacksonville city, Florida",309087,4957,185063,5076,124024,4832
1600000US1236100,1236100,"Kendall CDP, Florida",28757,2162,19329,1962,9428,1604
1600000US1238250,1238250,"Lakeland city, Florida",39638,1864,21130,1611,18508,1567
1600000US1239425,1239425,"Largo city, Florida",37490,2016,20060,1777,17430,1789
1600000US1239550,1239550,"Lauderhill city, Florida",24410,1947,12522,1426,11888,1595
1600000US1239925,1239925,"Lehigh Acres CDP, Florida",31088,1943,18547,1544,12541,1547
1600000US1243975,1243975,"Melbourne city, Florida",33007,1882,19927,1710,13080,1719
1600000US1245000,1245000,"Miami city, Florida",153740,4031,49688,2718,104052,4116
1600000US1245025,1245025,"Miami Beach city, Florida",43453,2192,15521,1716,27932,1690
1600000US1245060,1245060,"Miami Gardens city, Florida",31109,1483,21544,1708,9565,1472
1600000US1245975,1245975,"Miramar city, Florida",38090,1997,28863,2047,9227,1893
1600000US1253000,1253000,"Orlando city, Florida",102564,3739,37425,2442,65139,3247
1600000US1254000,1254000,"Palm Bay city, Florida",37700,2300,27384,2260,10316,1774
1600000US1254200,1254200,"Palm Coast city, Florida",28105,1785,21811,1694,6294,1269
1600000US1255775,1255775,"Pembroke Pines city, Florida",57150,2648,41198,2663,15952,2028
1600000US1256825,1256825,"Pine Hills CDP, Florida",18592,1686,10724,1366,7868,1480
1600000US1257425,1257425,"Plantation city, Florida",33753,1580,22426,1741,11327,1634
1600000US1258050,1258050,"Pompano Beach city, Florida",39679,2327,23833,2212,15846,1715
1600000US1258715,1258715,"Port St. Lucie city, Florida",59766,2410,45885,2925,13881,2342
1600000US1260950,1260950,"Riverview CDP, Florida",26709,1865,19281,1659,7428,1630
1600000US1263000,1263000,"St. Petersburg city, Florida",105668,2623,60817,2624,44851,2510
1600000US1268350,1268350,"Spring Hill CDP, Florida",38264,2127,29474,2087,8790,1500
1600000US1269700,1269700,"Sunrise city, Florida",31667,1626,22749,1619,8918,1340
1600000US1270600,1270600,"Tallahassee city, Florida",72133,2547,29128,1694,43005,2672
1600000US1271000,1271000,"Tampa city, Florida",139401,3881,67099,3194,72302,3251
1600000US1272145,1272145,"Town 'n' Country CDP, Florida",29326,2317,17759,1759,11567,1673
1600000US1276582,1276582,"Weston city, Florida",20612,1419,15939,1613,4673,1041
1600000US1276600,1276600,"West Palm Beach city, Florida",43303,2809,22296,1904,21007,2142
1600000US1301052,1301052,"Albany city, Georgia",29597,1420,11458,1072,18139,1491
1600000US1303440,1303440,"Athens-Clarke County unified government (balance), Georgia",40219,1819,17998,1385,22221,1913
1600000US1304000,1304000,"Atlanta city, Georgia",183442,4525,80223,3254,103219,3749
1600000US1304204,1304204,"Augusta-Richmond County consolidated government (balance), Georgia",71633,2160,37193,1884,34440,2257
1600000US1319000,1319000,"Columbus city, Georgia",71719,2110,37373,2063,34346,2276
1600000US1342425,1342425,"Johns Creek city, Georgia",26316,1269,20928,1775,5388,1228
1600000US1349000,1349000,"Macon city, Georgia",31995,1847,13714,1342,18281,1556
1600000US1367284,1367284,"Roswell city, Georgia",34529,1862,22538,1756,11991,1582
1600000US1368516,1368516,"Sandy Springs city, Georgia",42305,2280,18990,1811,23315,2038
1600000US1369000,1369000,"Savannah city, Georgia",53257,2359,22930,1717,30327,2322
1600000US1380508,1380508,"Warner Robins city, Georgia",25761,1594,14786,1600,10975,1708
1600000US1571550,1571550,"Urban Honolulu CDP, Hawaii",124455,2940,52456,2323,71999,2594
1600000US1608830,1608830,"Boise City city, Idaho",88900,2055,51227,2840,37673,2273
1600000US1652120,1652120,"Meridian city, Idaho",26174,1330,19140,1970,7034,1359
1600000US1656260,1656260,"Nampa city, Idaho",27680,1451,16618,1517,11062,1832
1600000US1702154,1702154,"Arlington Heights village, Illinois",30711,1650,23086,1303,7625,1342
1600000US1703012,1703012,"Aurora city, Illinois",63858,2112,44708,2145,19150,1785
1600000US1706613,1706613,"Bloomington city, Illinois",32244,1062,19616,1351,12628,1435
1600000US1707133,1707133,"Bolingbrook village, Illinois",22039,1224,17886,1191,4153,877
1600000US1712385,1712385,"Champaign city, Illinois",33123,1889,16415,1345,16708,1782
1600000US1714000,1714000,"Chicago city, Illinois",1032074,6757,457833,7497,574241,7637
1600000US1714351,1714351,"Cicero town, Illinois",20267,1279,9808,898,10459,1399
1600000US1718823,1718823,"Decatur city, Illinois",32737,1181,19488,1299,13249,1391
1600000US1723074,1723074,"Elgin city, Illinois",33548,2142,22041,2099,11507,1419
1600000US1724582,1724582,"Evanston city, Illinois",27527,1703,14802,1366,12725,1572
1600000US1738570,1738570,"Joliet city, Illinois",47376,2105,35044,1820,12332,1493
1600000US1751622,1751622,"Naperville city, Illinois",49444,1568,38329,1703,11115,1304
1600000US1757225,1757225,"Palatine village, Illinois",26369,1375,18169,1514,8200,1356
1600000US1759000,1759000,"Peoria city, Illinois",47852,1780,26285,1917,21567,1676
1600000US1765000,1765000,"Rockford city, Illinois",58817,1790,31858,1990,26959,1607
1600000US1768003,1768003,"Schaumburg village, Illinois",29500,1875,19165,1690,10335,1323
1600000US1770122,1770122,"Skokie village, Illinois",23208,1501,16175,1335,7033,1054
1600000US1772000,1772000,"Springfield city, Illinois",49776,1588,31831,1668,17945,1717
1600000US1779293,1779293,"Waukegan city, Illinois",28115,1547,14033,1237,14082,1405
1600000US1805860,1805860,"Bloomington city, Indiana",28890,1647,9466,1122,19424,1687
1600000US1810342,1810342,"Carmel city, Indiana",31169,1375,23992,1514,7177,1266
1600000US1822000,1822000,"Evansville city, Indiana",51135,1805,27636,1443,23499,1620
1600000US1823278,1823278,"Fishers town, Indiana",28840,1545,23947,1513,4893,1068
1600000US1825000,1825000,"Fort Wayne city, Indiana",100724,2012,63445,2075,37279,2117
1600000US1827000,1827000,"Gary city, Indiana",28420,1859,14596,1304,13824,1374
1600000US1831000,1831000,"Hammond city, Indiana",27471,1369,16580,1292,10891,1171
1600000US1836003,1836003,"Indianapolis city (balance), Indiana",330478,3663,176055,4652,154423,4829
1600000US1840788,1840788,"Lafayette city, Indiana",28673,1348,15130,1364,13543,1382
1600000US1851876,1851876,"Muncie city, Indiana",28058,1328,13799,1163,14259,1262
1600000US1871000,1871000,"South Bend city, Indiana",39614,1631,23863,1428,15751,1470
1600000US1912000,1912000,"Cedar Rapids city, Iowa",50824,1717,35068,1587,15756,1745
1600000US1919000,1919000,"Davenport city, Iowa",40610,1338,24874,1342,15736,1338
1600000US1921000,1921000,"Des Moines city, Iowa",81387,2390,51479,2205,29908,1849
1600000US1938595,1938595,"Iowa City city, Iowa",28398,1381,13865,1062,14533,1239
1600000US1973335,1973335,"Sioux City city, Iowa",30608,1171,19637,1537,10971,1443
1600000US1982425,1982425,"Waterloo city, Iowa",28698,1071,19147,1084,9551,1163
1600000US2036000,2036000,"Kansas City city, Kansas",54053,1581,31358,1521,22695,1402
1600000US2038900,2038900,"Lawrence city, Kansas",34317,1690,15789,1406,18528,1664
1600000US2052575,2052575,"Olathe city, Kansas",46069,1609,34098,1474,11971,1380
1600000US2053775,2053775,"Overland Park city, Kansas",74396,1744,48033,2184,26363,1970
1600000US2071000,2071000,"Topeka city, Kansas",52180,1628,28784,1698,23396,1854
1600000US2079000,2079000,"Wichita city, Kansas",151253,2683,90421,3146,60832,2963
1600000US2146027,2146027,"Lexington-Fayette urban county, Kentucky",122920,2069,66834,2206,56086,2448
1600000US2148006,2148006,"Louisville/Jefferson County metro government (balance), Kentucky",245530,3260,148215,3482,97315,3301
1600000US2205000,2205000,"Baton Rouge city, Louisiana",88336,3332,45155,2816,43181,2450
1600000US2239475,2239475,"Kenner city, Louisiana",25283,1536,15399,1384,9884,1335
1600000US2240735,2240735,"Lafayette city, Louisiana",48363,1913,27146,2076,21217,2083
1600000US2241155,2241155,"Lake Charles city, Louisiana",30188,1423,16465,1544,13723,1433
1600000US2250115,2250115,"Metairie CDP, Louisiana",56718,2175,33154,1738,23564,2156
1600000US2255000,2255000,"New Orleans city, Louisiana",151735,2526,71657,2494,80078,2747
1600000US2270000,2270000,"Shreveport city, Louisiana",77988,2046,42274,1976,35714,2226
1600000US2360545,2360545,"Portland city, Maine",30920,1533,13726,1255,17194,1409
1600000US2404000,2404000,"Baltimore city, Maryland",244397,3814,113191,4100,131206,4178
1600000US2419125,2419125,"Columbia CDP, Maryland",40244,1858,26522,1387,13722,1722
1600000US2426000,2426000,"Ellicott City CDP, Maryland",24997,1198,19447,1107,5550,1008
1600000US2430325,2430325,"Frederick city, Maryland",26526,1576,14624,1242,11902,1590
1600000US2432025,2432025,"Germantown CDP, Maryland",31262,1954,21142,1637,10120,1674
1600000US2432650,2432650,"Glen Burnie CDP, Maryland",27118,1813,15890,1422,11228,1397
1600000US2472450,2472450,"Silver Spring CDP, Maryland",29884,1680,11502,874,18382,1716
1600000US2481175,2481175,"Waldorf CDP, Maryland",25351,1468,17702,1394,7649,1180
1600000US2507000,2507000,"Boston city, Massachusetts",247254,3859,82093,3044,165161,4226
1600000US2509000,2509000,"Brockton city, Massachusetts",32592,1682,19857,1688,12735,1490
1600000US2511000,2511000,"Cambridge city, Massachusetts",43506,1992,16771,1347,26735,1610
1600000US2523000,2523000,"Fall River city, Massachusetts",39000,1521,12692,1192,26308,1606
1600000US2524960,2524960,"Framingham CDP, Massachusetts",28060,1651,14682,1463,13378,1585
1600000US2534550,2534550,"Lawrence city, Massachusetts",25489,1280,7122,1023,18367,1269
1600000US2537000,2537000,"Lowell city, Massachusetts",40270,1810,17105,1859,23165,1867
1600000US2537490,2537490,"Lynn city, Massachusetts",32266,1561,14035,1356,18231,1556
1600000US2545000,2545000,"New Bedford city, Massachusetts",39719,1677,17991,1495,21728,1478
1600000US2545560,2545560,"Newton city, Massachusetts",30224,1469,22262,1219,7962,1202
1600000US2555745,2555745,"Quincy city, Massachusetts",39587,2117,18724,1727,20863,2007
1600000US2562535,2562535,"Somerville city, Massachusetts",31516,1583,11237,1479,20279,1999
1600000US2567000,2567000,"Springfield city, Massachusetts",56742,1808,26973,1684,29769,1659
1600000US2582000,2582000,"Worcester city, Massachusetts",67017,2565,28022,1872,38995,2188
1600000US2603000,2603000,"Ann Arbor city, Michigan",46735,2116,20368,1364,26367,1815
1600000US2621000,2621000,"Dearborn city, Michigan",31605,1707,21667,1619,9938,1227
1600000US2622000,2622000,"Detroit city, Michigan",253073,4212,126235,4009,126838,4034
1600000US2627440,2627440,"Farmington Hills city, Michigan",35898,1723,21769,1533,14129,1584
1600000US2629000,2629000,"Flint city, Michigan",41191,1948,23744,1862,17447,1694
1600000US2634000,2634000,"Grand Rapids city, Michigan",73510,2362,40126,2404,33384,2350
1600000US2642160,2642160,"Kalamazoo city, Michigan",27971,1480,12579,1219,15392,1560
1600000US2646000,2646000,"Lansing city, Michigan",47461,1668,23941,1362,23520,1488
1600000US2649000,2649000,"Livonia city, Michigan",36091,1498,30174,1485,5917,806
1600000US2669035,2669035,"Rochester Hills city, Michigan",27893,1245,20929,1322,6964,1088
1600000US2674900,2674900,"Southfield city, Michigan",31724,1642,15568,1304,16156,1516
1600000US2676460,2676460,"Sterling Heights city, Michigan",47914,1691,34233,1687,13681,1841
1600000US2680700,2680700,"Troy city, Michigan",30838,1198,22612,1204,8226,906
1600000US2684000,2684000,"Warren city, Michigan",52262,1880,37102,2022,15160,1762
1600000US2686000,2686000,"Westland city, Michigan",32739,1742,19367,1287,13372,1546
1600000US2688940,2688940,"Wyoming city, Michigan",28127,1666,18332,1408,9795,1449
1600000US2706616,2706616,"Bloomington city, Minnesota",36472,1386,24239,1523,12233,1248
1600000US2707966,2707966,"Brooklyn Park city, Minnesota",27562,1354,18620,1341,8942,1453
1600000US2717000,2717000,"Duluth city, Minnesota",35025,1520,20947,1232,14078,1262
1600000US2743000,2743000,"Minneapolis city, Minnesota",165854,3196,80029,2516,85825,2981
1600000US2751730,2751730,"Plymouth city, Minnesota",29100,1071,21004,1276,8096,1110
1600000US2754880,2754880,"Rochester city, Minnesota",43101,1150,30216,1111,12885,1168
1600000US2756896,2756896,"St. Cloud city, Minnesota",25168,1440,13575,1266,11593,1372
1600000US2758000,2758000,"St. Paul city, Minnesota",111917,2232,56071,2576,55846,2549
1600000US2829700,2829700,"Gulfport city, Mississippi",28760,1670,15561,1829,13199,1363
1600000US2836000,2836000,"Jackson city, Mississippi",62721,1998,32875,2044,29846,1969
1600000US2915670,2915670,"Columbia city, Missouri",44645,1804,21101,1751,23544,1773
1600000US2935000,2935000,"Independence city, Missouri",47027,1898,32683,1689,14344,1793
1600000US2938000,2938000,"Kansas City city, Missouri",192367,3215,102778,3021,89589,3332
1600000US2941348,2941348,"Lee's Summit city, Missouri",33388,1380,24153,1610,9235,1551
1600000US2954074,2954074,"O'Fallon city, Missouri",29609,1263,23892,1589,5717,1371
1600000US2964082,2964082,"St. Charles city, Missouri",26069,1424,16569,1333,9500,1132
1600000US2964550,2964550,"St. Joseph city, Missouri",29302,1174,17673,1252,11629,1153
1600000US2965000,2965000,"St. Louis city, Missouri",139930,2646,61932,2699,77998,2913
1600000US2970000,2970000,"Springfield city, Missouri",70268,2055,32443,1920,37825,2564
1600000US3006550,3006550,"Billings city, Montana",44587,1274,27981,1598,16606,1552
1600000US3050200,3050200,"Missoula city, Montana",29323,1343,13888,1446,15435,1775
1600000US3128000,3128000,"Lincoln city, Nebraska",106373,1960,59400,2051,46973,2392
1600000US3137000,3137000,"Omaha city, Nebraska",166736,2769,93990,2695,72746,2601
1600000US3223770,3223770,"Enterprise CDP, Nevada",42518,3187,23483,2420,19035,2461
1600000US3231900,3231900,"Henderson city, Nevada",100083,2970,60566,3018,39517,2544
1600000US3240000,3240000,"Las Vegas city, Nevada",216779,4260,115847,3966,100932,4408
1600000US3251800,3251800,"North Las Vegas city, Nevada",67526,2278,37317,2416,30209,2226
1600000US3254600,3254600,"Paradise CDP, Nevada",89883,3348,35769,2403,54114,2790
1600000US3260600,3260600,"Reno city, Nevada",88816,2918,41806,2194,47010,2547
1600000US3268400,3268400,"Sparks city, Nevada",36038,1481,20809,1709,15229,1553
1600000US3268585,3268585,"Spring Valley CDP, Nevada",68074,3372,30628,2321,37446,2814
1600000US3271400,3271400,"Sunrise Manor CDP, Nevada",60442,2391,30280,1843,30162,1930
1600000US3345140,3345140,"Manchester city, New Hampshire",45059,1836,21869,1921,23190,1832
1600000US3350260,3350260,"Nashua city, New Hampshire",35315,1568,20791,1655,14524,1415
1600000US3410000,3410000,"Camden city, New Jersey",24329,1625,9130,1301,15199,1524
1600000US3413690,3413690,"Clifton city, New Jersey",29318,1243,17893,1542,11425,1559
1600000US3419390,3419390,"East Orange city, New Jersey",25894,1465,6658,933,19236,1569
1600000US3421000,3421000,"Elizabeth city, New Jersey",39054,1781,9664,1229,29390,1931
1600000US3436000,3436000,"Jersey City city, New Jersey",97144,2590,28956,2213,68188,3199
1600000US3451000,3451000,"Newark city, New Jersey",92479,2473,20422,1541,72057,2533
1600000US3456550,3456550,"Passaic city, New Jersey",18766,1169,3800,732,14966,1137
1600000US3457000,3457000,"Paterson city, New Jersey",43838,1899,11403,1412,32435,1985
1600000US3473110,3473110,"Toms River CDP, New Jersey",33978,1748,27384,1710,6594,992
1600000US3474000,3474000,"Trenton city, New Jersey",28599,2009,10259,1623,18340,1585
1600000US3474630,3474630,"Union City city, New Jersey",23268,1252,4512,762,18756,1331
1600000US3502000,3502000,"Albuquerque city, New Mexico",224301,2994,134469,3919,89832,4033
1600000US3539380,3539380,"Las Cruces city, New Mexico",37176,1445,21377,1831,15799,1905
1600000US3563460,3563460,"Rio Rancho city, New Mexico",31603,1139,25622,1471,5981,1138
1600000US3570500,3570500,"Santa Fe city, New Mexico",32287,1230,18828,1282,13459,1267
1600000US3601000,3601000,"Albany city, New York",39405,1714,15641,1551,23764,1838
1600000US3611000,3611000,"Buffalo city, New York",109765,2451,45956,2416,63809,3082
1600000US3615000,3615000,"Cheektowaga CDP, New York",32471,1242,24068,1354,8403,1132
1600000US3649121,3649121,"Mount Vernon city, New York",25958,1513,10080,992,15878,1579
1600000US3650617,3650617,"New Rochelle city, New York",27758,1233,14217,1281,13541,1338
1600000US3651000,3651000,"New York city, New York",3085814,9466,979125,11599,2106689,12933
1600000US3663000,3663000,"Rochester city, New York",87060,2497,32759,1887,54301,2521
1600000US3665508,3665508,"Schenectady city, New York",24356,1324,10964,1186,13392,1260
1600000US3673000,3673000,"Syracuse city, New York",54939,2273,22122,1599,32817,2054
1600000US3684000,3684000,"Yonkers city, New York",72546,2606,34126,2298,38420,2278
1600000US3702140,3702140,"Asheville city, North Carolina",35149,1842,19465,1557,15684,1813
1600000US3710740,3710740,"Cary town, North Carolina",54559,1583,35559,1676,19000,1753
1600000US3712000,3712000,"Charlotte city, North Carolina",295863,4105,160794,4120,135069,4226
1600000US3714100,3714100,"Concord city, North Carolina",28641,1478,20094,1420,8547,1186
1600000US3719000,3719000,"Durham city, North Carolina",99680,1897,49258,2174,50422,2625
1600000US3722920,3722920,"Fayetteville city, North Carolina",77417,1872,37453,1844,39964,2042
1600000US3725580,3725580,"Gastonia city, North Carolina",26495,1237,14622,1236,11873,1060
1600000US3728000,3728000,"Greensboro city, North Carolina",112287,2903,56980,2553,55307,2865
1600000US3728080,3728080,"Greenville city, North Carolina",37154,1723,12301,1642,24853,2091
1600000US3731400,3731400,"High Point city, North Carolina",42965,1842,25183,1710,17782,1604
1600000US3734200,3734200,"Jacksonville city, North Carolina",21225,1602,8271,1048,12954,1705
1600000US3755000,3755000,"Raleigh city, North Carolina",166003,3788,83378,3411,82625,3935
1600000US3774440,3774440,"Wilmington city, North Carolina",46045,1908,22095,1721,23950,1777
1600000US3775000,3775000,"Winston-Salem city, North Carolina",93303,2226,49642,2170,43661,2320
1600000US3825700,3825700,"Fargo city, North Dakota",47781,1743,21478,1421,26303,1911
1600000US3901000,3901000,"Akron city, Ohio",83193,2308,43588,2395,39605,2907
1600000US3912000,3912000,"Canton city, Ohio",30702,1854,16917,1437,13785,1327
1600000US3915000,3915000,"Cincinnati city, Ohio",130255,2747,48644,2643,81611,2973
1600000US3916000,3916000,"Cleveland city, Ohio",162717,4028,66966,2890,95751,3374
1600000US3918000,3918000,"Columbus city, Ohio",329502,4256,149381,4486,180121,5274
1600000US3921000,3921000,"Dayton city, Ohio",55458,2419,27450,1803,28008,1828
1600000US3944856,3944856,"Lorain city, Ohio",25319,1366,15223,1251,10096,1147
1600000US3961000,3961000,"Parma city, Ohio",33073,1752,23548,1928,9525,1308
1600000US3977000,3977000,"Toledo city, Ohio",118004,2726,63667,2613,54337,3154
1600000US3988000,3988000,"Youngstown city, Ohio",25506,1685,14773,1068,10733,1134
1600000US4009050,4009050,"Broken Arrow city, Oklahoma",37183,1328,28685,1284,8498,978
1600000US4023200,4023200,"Edmond city, Oklahoma",28967,1170,19658,1190,9309,1094
1600000US4041850,4041850,"Lawton city, Oklahoma",34240,1427,17992,1429,16248,1534
1600000US4052500,4052500,"Norman city, Oklahoma",44294,2011,24624,1797,19670,1787
1600000US4055000,4055000,"Oklahoma City city, Oklahoma",228620,2904,133957,3835,94663,3465
1600000US4075000,4075000,"Tulsa city, Oklahoma",163293,1912,83930,1963,79363,1992
1600000US4105350,4105350,"Beaverton city, Oregon",36608,1811,16655,1875,19953,1539
1600000US4105800,4105800,"Bend city, Oregon",32379,1498,20434,1791,11945,1646
1600000US4123850,4123850,"Eugene city, Oregon",67678,2122,33528,2123,34150,1784
1600000US4131250,4131250,"Gresham city, Oregon",39267,2159,20863,2165,18404,1489
1600000US4134100,4134100,"Hillsboro city, Oregon",32400,1603,17711,1486,14689,1270
1600000US4147000,4147000,"Medford city, Oregon",29499,1884,16123,1687,13376,1544
1600000US4159000,4159000,"Portland city, Oregon",248698,3159,132005,3960,116693,3885
1600000US4164900,4164900,"Salem city, Oregon",56923,2047,31491,2255,25432,2394
1600000US4202000,4202000,"Allentown city, Pennsylvania",42194,1748,20055,2000,22139,1647
1600000US4206088,4206088,"Bethlehem city, Pennsylvania",30601,1962,15029,1196,15572,1608
1600000US4224000,4224000,"Erie city, Pennsylvania",42224,1699,20635,1264,21589,1614
1600000US4260000,4260000,"Philadelphia city, Pennsylvania",579874,5204,302551,6569,277323,6610
1600000US4261000,4261000,"Pittsburgh city, Pennsylvania",131513,2924,62733,2063,68780,2999
1600000US4263624,4263624,"Reading city, Pennsylvania",29594,1513,12242,1260,17352,1536
1600000US4269000,4269000,"Scranton city, Pennsylvania",29796,1259,14109,1150,15687,1085
1600000US4419180,4419180,"Cranston city, Rhode Island",29814,1690,20465,1424,9349,1365
1600000US4454640,4454640,"Pawtucket city, Rhode Island",28660,1642,12424,1170,16236,1511
1600000US4459000,4459000,"Providence city, Rhode Island",61892,1937,21212,1944,40680,2244
1600000US4474300,4474300,"Warwick city, Rhode Island",35480,1306,24241,1667,11239,1599
1600000US4513330,4513330,"Charleston city, South Carolina",52784,2099,27819,1869,24965,1815
1600000US4516000,4516000,"Columbia city, South Carolina",42244,2284,19912,1719,22332,1603
1600000US4548535,4548535,"Mount Pleasant town, South Carolina",27990,1818,17998,2140,9992,1641
1600000US4550875,4550875,"North Charleston city, South Carolina",36884,1882,17993,1786,18891,1630
1600000US4561405,4561405,"Rock Hill city, South Carolina",26900,1640,12516,1203,14384,1567
1600000US4652980,4652980,"Rapid City city, South Dakota",27473,1419,15484,1113,11989,1404
1600000US4659020,4659020,"Sioux Falls city, South Dakota",63044,1557,36421,1549,26623,1887
1600000US4714000,4714000,"Chattanooga city, Tennessee",69166,2475,36564,2290,32602,2318
1600000US4715160,4715160,"Clarksville city, Tennessee",49994,1967,26502,2093,23492,2047
1600000US4727740,4727740,"Franklin city, Tennessee",26131,1263,16867,1596,9264,1398
1600000US4737640,4737640,"Jackson city, Tennessee",24983,1377,13414,1392,11569,1292
1600000US4740000,4740000,"Knoxville city, Tennessee",85467,2513,41816,2343,43651,2358
1600000US4748000,4748000,"Memphis city, Tennessee",247478,3642,123895,4121,123583,4433
1600000US4751560,4751560,"Murfreesboro city, Tennessee",41477,1583,19872,1762,21605,1477
1600000US4752006,4752006,"Nashville-Davidson metropolitan government (balance), Tennessee",249102,3292,128079,3700,121023,3998
1600000US4801000,4801000,"Abilene city, Texas",42756,1592,22178,1649,20578,1741
1600000US4801924,4801924,"Allen city, Texas",28574,2059,21042,1916,7532,1417
1600000US4803000,4803000,"Amarillo city, Texas",74018,1407,45104,2027,28914,2200
1600000US4804000,4804000,"Arlington city, Texas",132941,3236,72997,3530,59944,2951
1600000US4804462,4804462,"Atascocita CDP, Texas",21107,2378,16686,1995,4421,1480
1600000US4805000,4805000,"Austin city, Texas",330838,4711,147758,4376,183080,4844
1600000US4806128,4806128,"Baytown city, Texas",25181,1631,16196,1466,8985,1530
1600000US4807000,4807000,"Beaumont city, Texas",45042,1715,25516,1784,19526,1899
1600000US4810768,4810768,"Brownsville city, Texas",52082,1858,32331,2081,19751,1718
1600000US4810912,4810912,"Bryan city, Texas",27010,1439,12557,1280,14453,1278
1600000US4813024,4813024,"Carrollton city, Texas",44446,2123,27386,1621,17060,1746
1600000US4815976,4815976,"College Station city, Texas",34900,1841,13789,1259,21111,2115
1600000US4817000,4817000,"Corpus Christi city, Texas",111078,2603,62280,2807,48798,2841
1600000US4819000,4819000,"Dallas city, Texas",463719,5838,196361,5226,267358,6437
1600000US4819972,4819972,"Denton city, Texas",42108,2251,20068,1559,22040,1966
1600000US4822660,4822660,"Edinburg city, Texas",26325,1488,16000,1570,10325,1411
1600000US4824000,4824000,"El Paso city, Texas",219578,2697,128104,3590,91474,3868
1600000US4826232,4826232,"Flower Mound town, Texas",21983,1217,18661,1502,3322,900
1600000US4827000,4827000,"Fort Worth city, Texas",268919,5025,152387,4713,116532,5166
1600000US4827684,4827684,"Frisco city, Texas",43031,1650,32540,1561,10491,1646
1600000US4829000,4829000,"Garland city, Texas",72355,2306,47246,2421,25109,2086
1600000US4830464,4830464,"Grand Prairie city, Texas",55558,2204,35817,2119,19741,2241
1600000US4832372,4832372,"Harlingen city, Texas",21585,1464,12277,1387,9308,1339
1600000US4835000,4835000,"Houston city, Texas",780364,9306,343902,7251,436462,8447
1600000US4837000,4837000,"Irving city, Texas",85392,2679,30555,1784,54837,2800
1600000US4839148,4839148,"Killeen city, Texas",45455,1993,22813,1835,22642,1812
1600000US4841464,4841464,"Laredo city, Texas",65445,1462,40628,1945,24817,2258
1600000US4841980,4841980,"League City city, Texas",33657,1972,24755,1851,8902,1708
1600000US4842508,4842508,"Lewisville city, Texas",40185,1810,17004,1338,23181,2117
1600000US4843888,4843888,"Longview city, Texas",28492,1431,15936,1311,12556,1309
1600000US4845000,4845000,"Lubbock city, Texas",89527,2251,47129,2527,42398,2706
1600000US4845384,4845384,"McAllen city, Texas",40960,2109,24155,2027,16805,1607
1600000US4845744,4845744,"McKinney city, Texas",46795,1895,32109,2043,14686,1800
1600000US4847892,4847892,"Mesquite city, Texas",46550,2183,27112,2024,19438,1807
1600000US4848072,4848072,"Midland city, Texas",41586,1355,25991,1610,15595,1719
1600000US4848768,4848768,"Mission city, Texas",23850,1486,16905,1791,6945,1377
1600000US4848804,4848804,"Missouri City city, Texas",23964,1396,20662,1350,3302,906
1600000US4852356,4852356,"North Richland Hills city, Texas",25198,1512,16142,1447,9056,1216
1600000US4853388,4853388,"Odessa city, Texas",37392,1522,24946,1623,12446,1571
1600000US4856000,4856000,"Pasadena city, Texas",48836,2248,26296,2013,22540,2056
1600000US4856348,4856348,"Pearland city, Texas",33106,1728,24948,2125,8158,1874
1600000US4857200,4857200,"Pharr city, Texas",21913,1767,12411,1709,9502,1550
1600000US4858016,4858016,"Plano city, Texas",99867,2785,64014,2747,35853,2083
1600000US4861796,4861796,"Richardson city, Texas",39317,1642,24416,1777,14901,1622
1600000US4863500,4863500,"Round Rock city, Texas",33621,1948,19391,1641,14230,1590
1600000US4864472,4864472,"San Angelo city, Texas",36636,1703,20265,1624,16371,1596
1600000US4865000,4865000,"San Antonio city, Texas",480693,5323,264368,6191,216325,5298
1600000US4870808,4870808,"Sugar Land city, Texas",25762,1520,21478,1572,4284,1203
1600000US4872176,4872176,"Temple city, Texas",24500,1483,14197,1242,10303,1488
1600000US4872656,4872656,"The Woodlands CDP, Texas",37645,3226,28682,2927,8963,1789
1600000US4874144,4874144,"Tyler city, Texas",38250,2209,20101,1617,18149,1952
1600000US4876000,4876000,"Waco city, Texas",45254,1763,22084,1577,23170,1754
1600000US4879000,4879000,"Wichita Falls city, Texas",37538,1956,20894,1648,16644,1978
1600000US4943660,4943660,"Layton city, Utah",22179,1102,16262,1282,5917,1145
1600000US4950150,4950150,"Millcreek CDP, Utah",24778,1573,14377,1177,10401,1255
1600000US4955980,4955980,"Ogden city, Utah",29471,1739,16937,1867,12534,1320
1600000US4957300,4957300,"Orem city, Utah",25299,1195,15788,1197,9511,1241
1600000US4962470,4962470,"Provo city, Utah",32632,1474,13369,1257,19263,1427
1600000US4965330,4965330,"St. George city, Utah",27034,1954,17223,1834,9811,1422
1600000US4967000,4967000,"Salt Lake City city, Utah",75556,2209,37380,2151,38176,2259
1600000US4967440,4967440,"Sandy city, Utah",28399,1295,22462,1440,5937,1125
1600000US4982950,4982950,"West Jordan city, Utah",32115,1774,23969,1843,8146,1510
1600000US4983470,4983470,"West Valley City city, Utah",36888,1537,26292,1744,10596,1392
1600000US5101000,5101000,"Alexandria city, Virginia",65468,1710,26210,1922,39258,2133
1600000US5103000,5103000,"Arlington CDP, Virginia",95369,2149,40017,2065,55352,2295
1600000US5114440,5114440,"Centreville CDP, Virginia",23740,1488,16254,1437,7486,1072
1600000US5116000,5116000,"Chesapeake city, Virginia",80343,1611,56351,2407,23992,2407
1600000US5121088,5121088,"Dale City CDP, Virginia",21147,1467,15034,1233,6113,1225
1600000US5135000,5135000,"Hampton city, Virginia",52797,1747,30148,1670,22649,2227
1600000US5147672,5147672,"Lynchburg city, Virginia",28000,1420,14614,1462,13386,1461
1600000US5156000,5156000,"Newport News city, Virginia",70446,1691,34967,1894,35479,2141
1600000US5157000,5157000,"Norfolk city, Virginia",86347,2086,36584,1657,49763,2335
1600000US5164000,5164000,"Portsmouth city, Virginia",36781,1136,19107,1199,17674,1517
1600000US5167000,5167000,"Richmond city, Virginia",83456,2202,36206,1792,47250,2307
1600000US5168000,5168000,"Roanoke city, Virginia",42134,1446,23180,1624,18954,1816
1600000US5176432,5176432,"Suffolk city, Virginia",30623,786,21819,1199,8804,1048
1600000US5182000,5182000,"Virginia Beach city, Virginia",165376,2131,102326,2841,63050,2871
1600000US5303180,5303180,"Auburn city, Washington",25863,1433,15777,1327,10086,1394
1600000US5305210,5305210,"Bellevue city, Washington",53387,1995,28742,1878,24645,2146
1600000US5305280,5305280,"Bellingham city, Washington",34993,1584,16051,1356,18942,1520
1600000US5322640,5322640,"Everett city, Washington",41062,2152,17195,1820,23867,1867
1600000US5323515,5323515,"Federal Way city, Washington",32960,1939,16952,1648,16008,1599
1600000US5335275,5335275,"Kennewick city, Washington",27634,1754,17669,1506,9965,1415
1600000US5335415,5335415,"Kent city, Washington",40869,2269,20669,1672,20200,1883
1600000US5353545,5353545,"Pasco city, Washington",18368,912,11534,1237,6834,1087
1600000US5357745,5357745,"Renton city, Washington",37863,2212,20131,1728,17732,2035
1600000US5363000,5363000,"Seattle city, Washington",289790,4363,132888,3805,156902,3821
1600000US5367000,5367000,"Spokane city, Washington",87692,2397,49167,2576,38525,2194
1600000US5367167,5367167,"Spokane Valley city, Washington",37224,1562,22455,1807,14769,1364
1600000US5370000,5370000,"Tacoma city, Washington",74723,2482,37497,2178,37226,2292
1600000US5374060,5374060,"Vancouver city, Washington",65293,2104,31466,1936,33827,2029
1600000US5380010,5380010,"Yakima city, Washington",33166,1565,18303,1401,14863,1468
1600000US5502375,5502375,"Appleton city, Wisconsin",28535,1436,19491,1301,9044,1115
1600000US5522300,5522300,"Eau Claire city, Wisconsin",27782,1126,14479,1054,13303,1255
1600000US5531000,5531000,"Green Bay city, Wisconsin",42555,1443,23624,1287,18931,1596
1600000US5539225,5539225,"Kenosha city, Wisconsin",37560,1268,21393,1710,16167,1697
1600000US5548000,5548000,"Madison city, Wisconsin",101379,2807,48798,2087,52581,2786
1600000US5553000,5553000,"Milwaukee city, Wisconsin",230960,3374,95432,3259,135528,3424
1600000US5560500,5560500,"Oshkosh city, Wisconsin",25904,1363,14232,1249,11672,1442
1600000US5566000,5566000,"Racine city, Wisconsin",30614,1498,16385,1412,14229,1507
1600000US5584250,5584250,"Waukesha city, Wisconsin",29722,1329,16433,1266,13289,1063
