GEO.id,GEO.id2,GEO.display-label,HD01_VD01,HD02_VD01,HD01_VD02,HD02_VD02,HD01_VD03,HD02_VD03
1600000US0107000,0107000,"Birmingham city, Alabama",88847,3120,41041,2536,47806,2599
1600000US0121184,0121184,"Dothan city, Alabama",26550,903,15617,848,10933,642
1600000US0135896,0135896,"Hoover city, Alabama",33198,1835,21797,1856,11401,1698
1600000US0137000,0137000,"Huntsville city, Alabama",79539,2179,44875,2157,34664,2453
1600000US0150000,0150000,"Mobile city, Alabama",74111,2734,41279,2414,32832,2622
1600000US0151000,0151000,"Montgomery city, Alabama",78388,2267,44222,2264,34166,2562
1600000US0177256,0177256,"Tuscaloosa city, Alabama",32945,1820,15937,1596,17008,1632
1600000US0203000,0203000,"Anchorage municipality, Alaska",103445,2136,61373,2310,42072,2414
1600000US0404720,0404720,"Avondale city, Arizona",24013,1207,13342,1187,10671,1286
1600000US0410670,0410670,"Casas Adobes CDP, Arizona",27323,1459,16806,1462,10517,1377
1600000US0412000,0412000,"Chandler city, Arizona",84762,2813,52932,2636,31830,2381
1600000US0423620,0423620,"Flagstaff city, Arizona",25531,1514,10543,1374,14988,1764
1600000US0427400,0427400,"Gilbert town, Arizona",72012,2286,53215,2307,18797,2114
1600000US0427820,0427820,"Glendale city, Arizona",79503,2706,42890,2360,36613,2314
1600000US0428380,0428380,"Goodyear city, Arizona",23549,1810,17209,1950,6340,1251
1600000US0446000,0446000,"Mesa city, Arizona",166515,4446,98696,3449,67819,3500
1600000US0454050,0454050,"Peoria city, Arizona",59438,2218,40030,2449,19408,1830
1600000US0455000,0455000,"Phoenix city, Arizona",517276,6964,271090,6298,246186,6172
1600000US0464210,0464210,"San Tan Valley CDP, Arizona",26288,1879,18110,1869,8178,1596
1600000US0465000,0465000,"Scottsdale city, Arizona",99860,3738,65386,3304,34474,2826
1600000US0471510,0471510,"Surprise city, Arizona",48007,1969,34807,2369,13200,1943
1600000US0473000,0473000,"Tempe city, Arizona",63682,2532,25400,2005,38282,2748
1600000US0477000,0477000,"Tucson city, Arizona",207615,3745,97890,3002,109725,3721
1600000US0485540,0485540,"Yuma city, Arizona",32012,1777,19113,1497,12899,1743
1600000US0523290,0523290,"Fayetteville city, Arkansas",30590,2170,11943,1590,18647,1821
1600000US0524550,0524550,"Fort Smith city, Arkansas",34603,1350,16266,1605,18337,1792
1600000US0535710,0535710,"Jonesboro city, Arkansas",26475,1187,12728,1227,13747,1433
1600000US0541000,0541000,"Little Rock city, Arkansas",77116,2696,44458,2399,32658,2617
1600000US0550450,0550450,"North Little Rock city, Arkansas",25589,1722,15046,1847,10543,1446
1600000US0566080,0566080,"Springdale city, Arkansas",26134,1827,12799,1542,13335,1778
1600000US0600562,0600562,"Alameda city, California",29846,1460,13328,1351,16518,1536
1600000US0600884,0600884,"Alhambra city, California",30595,1545,12040,1447,18555,1504
1600000US0602000,0602000,"Anaheim city, California",99302,2804,46912,2647,52390,2342
1600000US0602252,0602252,"Antioch city, California",34223,1705,20086,2012,14137,1381
1600000US0602364,0602364,"Apple Valley town, California",23885,1629,16596,1678,7289,1307
1600000US0602553,0602553,"Arden-Arcade CDP, California",40190,2027,17034,1428,23156,1976
1600000US0603526,0603526,"Bakersfield city, California",111136,2975,57750,3529,53386,3519
1600000US0603666,0603666,"Baldwin Park city, California",17758,907,10679,1091,7079,1189
1600000US0604982,0604982,"Bellflower city, California",22988,1382,10637,1274,12351,1518
1600000US0606000,0606000,"Berkeley city, California",46030,1764,18913,1565,27117,1662
1600000US0608786,0608786,"Buena Park city, California",23151,1293,11923,1264,11228,1376
1600000US0608954,0608954,"Burbank city, California",42757,2142,16505,1999,26252,2087
1600000US0610046,0610046,"Camarillo city, California",23370,1496,15884,1683,7486,1162
1600000US0611194,0611194,"Carlsbad city, California",43572,2152,27933,1798,15639,2163
1600000US0611390,0611390,"Carmichael CDP, California",26047,1654,13365,1217,12682,1767
1600000US0611530,0611530,"Carson city, California",25239,1656,19075,1745,6164,1166
1600000US0613014,0613014,"Chico city, California",35302,1751,15363,1474,19939,1699
1600000US0613210,0613210,"Chino city, California",19107,1173,13955,1170,5152,899
1600000US0613214,0613214,"Chino Hills city, California",23398,1185,17666,1160,5732,1051
1600000US0613392,0613392,"Chula Vista city, California",76687,2799,44919,2738,31768,2795
1600000US0613588,0613588,"Citrus Heights city, California",32916,1792,17458,1562,15458,1402
1600000US0614218,0614218,"Clovis city, California",32778,1435,19740,1475,13038,1455
1600000US0615044,0615044,"Compton city, California",22811,1528,12031,1135,10780,1341
1600000US0616000,0616000,"Concord city, California",45531,1721,27781,2141,17750,1718
1600000US0616350,0616350,"Corona city, California",48285,1773,31035,1812,17250,1584
1600000US0616532,0616532,"Costa Mesa city, California",40177,1994,15937,1681,24240,1812
1600000US0617918,0617918,"Daly City city, California",32096,2235,18293,1930,13803,1651
1600000US0618100,0618100,"Davis city, California",24871,1199,10816,1025,14055,1267
1600000US0619766,0619766,"Downey city, California",31998,1929,16946,1984,15052,1492
1600000US0620802,0620802,"East Los Angeles CDP, California",32464,1806,10415,1134,22049,1648
1600000US0621712,0621712,"El Cajon city, California",32581,1523,12258,1498,20323,1444
1600000US0622020,0622020,"Elk Grove city, California",48838,2100,34726,2290,14112,1865
1600000US0622230,0622230,"El Monte city, California",31419,1604,11514,1319,19905,1670
1600000US0622804,0622804,"Escondido city, California",44668,2151,21411,1967,23257,1707
1600000US0623182,0623182,"Fairfield city, California",34112,1676,17433,1733,16679,1343
1600000US0624638,0624638,"Folsom city, California",25789,1431,17398,1383,8391,1215
1600000US0624680,0624680,"Fontana city, California",46968,2021,30755,2156,16213,1727
1600000US0626000,0626000,"Fremont city, California",74204,2088,45501,2319,28703,2087
1600000US0627000,0627000,"Fresno city, California",161474,3304,74135,3173,87339,2997
1600000US0628000,0628000,"Fullerton city, California",44304,2043,22887,2015,21417,1824
1600000US0629000,0629000,"Garden Grove city, California",46034,2060,25896,1617,20138,1582
1600000US0630000,0630000,"Glendale city, California",70660,2268,24129,1750,46531,2525
1600000US0632548,0632548,"Hawthorne city, California",29038,1893,7892,1093,21146,2023
1600000US0633000,0633000,"Hayward city, California",46879,2060,23596,1792,23283,1929
1600000US0633182,0633182,"Hemet city, California",30364,1874,17628,1982,12736,1493
1600000US0633434,0633434,"Hesperia city, California",25290,1306,14896,1333,10394,1370
1600000US0636000,0636000,"Huntington Beach city, California",74461,2082,42075,2344,32386,2559
1600000US0636448,0636448,"Indio city, California",26368,1487,16256,1350,10112,1282
1600000US0636546,0636546,"Inglewood city, California",36681,2135,13108,1423,23573,2053
1600000US0636770,0636770,"Irvine city, California",84808,2619,42335,2718,42473,2477
1600000US0637692,0637692,"Jurupa Valley city, California",24998,1362,15378,1502,9620,1361
1600000US0639496,0639496,"Lake Forest city, California",26534,1474,18119,1594,8415,1244
1600000US0639892,0639892,"Lakewood city, California",25341,1189,17132,1613,8209,1301
1600000US0640130,0640130,"Lancaster city, California",50583,2294,27847,2087,22736,2050
1600000US0641992,0641992,"Livermore city, California",29509,1650,20506,1810,9003,1312
1600000US0643000,0643000,"Long Beach city, California",165125,4560,66960,2786,98165,3973
1600000US0644000,0644000,"Los Angeles city, California",1320167,9304,473615,7899,846552,8749
1600000US0644574,0644574,"Lynwood city, California",15031,1006,6289,1027,8742,901
1600000US0645484,0645484,"Manteca city, California",21845,1236,13016,1283,8829,1187
1600000US0646842,0646842,"Menifee city, California",27774,1266,19737,1471,8037,1383
1600000US0646898,0646898,"Merced city, California",24848,1326,9460,1312,15388,1436
1600000US0647766,0647766,"Milpitas city, California",20668,981,13130,1233,7538,1035
1600000US0648256,0648256,"Mission Viejo city, California",34809,1769,28634,1770,6175,1303
1600000US0648354,0648354,"Modesto city, California",69496,2224,36802,2193,32694,2639
1600000US0649270,0649270,"Moreno Valley city, California",50253,1973,29920,2009,20333,1881
1600000US0649670,0649670,"Mountain View city, California",32824,1776,14348,1545,18476,1401
1600000US0650076,0650076,"Murrieta city, California",33271,1657,21974,1880,11297,1897
1600000US0650258,0650258,"Napa city, California",27476,1273,14710,1407,12766,1362
1600000US0651182,0651182,"Newport Beach city, California",37332,1561,20462,1559,16870,1522
1600000US0652526,0652526,"Norwalk city, California",27085,1451,16657,1536,10428,1330
1600000US0653000,0653000,"Oakland city, California",154214,3611,62058,2541,92156,3804
1600000US0653322,0653322,"Oceanside city, California",63130,2523,32875,2482,30255,2545
1600000US0653896,0653896,"Ontario city, California",47233,1941,25486,1933,21747,1780
1600000US0653980,0653980,"Orange city, California",41979,2155,23293,2224,18686,1687
1600000US0654652,0654652,"Oxnard city, California",50820,1973,26918,1947,23902,1739
1600000US0655156,0655156,"Palmdale city, California",44467,1883,29108,2111,15359,1877
1600000US0655282,0655282,"Palo Alto city, California",26315,1183,13949,1148,12366,1206
1600000US0656000,0656000,"Pasadena city, California",54352,2069,24013,1851,30339,2338
1600000US0656700,0656700,"Perris city, California",16881,1292,10439,1539,6442,1254
1600000US0657456,0657456,"Pittsburg city, California",21368,1630,10397,1341,10971,1224
1600000US0657792,0657792,"Pleasanton city, California",26500,1192,18374,1239,8126,1432
1600000US0658072,0658072,"Pomona city, California",39470,1707,20512,1737,18958,1555
1600000US0659444,0659444,"Rancho Cordova city, California",24032,1085,12681,1185,11351,1054
1600000US0659451,0659451,"Rancho Cucamonga city, California",54674,2526,33249,2138,21425,1973
1600000US0659920,0659920,"Redding city, California",35087,1731,18191,1496,16896,1591
1600000US0659962,0659962,"Redlands city, California",23956,1629,13817,1591,10139,1304
1600000US0660018,0660018,"Redondo Beach city, California",28521,1576,14682,1419,13839,1813
1600000US0660102,0660102,"Redwood City city, California",28091,1584,14352,1425,13739,1361
1600000US0660466,0660466,"Rialto city, California",25482,1223,15531,1386,9951,1171
1600000US0660620,0660620,"Richmond city, California",36004,1849,18095,1623,17909,1808
1600000US0662000,0662000,"Riverside city, California",89596,3089,47916,2321,41680,2542
1600000US0662938,0662938,"Roseville city, California",45988,1644,28126,1709,17862,1646
1600000US0664000,0664000,"Sacramento city, California",175350,3857,80708,3525,94642,3885
1600000US0664224,0664224,"Salinas city, California",40369,1924,17361,1762,23008,1541
1600000US0665000,0665000,"San Bernardino city, California",56274,2417,26254,2190,30020,1600
1600000US0665042,0665042,"San Buenaventura (Ventura) city, California",41793,1853,21920,1924,19873,1890
1600000US0665084,0665084,"San Clemente city, California",24902,1720,15910,1749,8992,1365
1600000US0666000,0666000,"San Diego city, California",480730,6318,223667,5386,257063,5246
1600000US0667000,0667000,"San Francisco city, California",354651,3606,127211,4092,227440,4797
1600000US0668000,0668000,"San Jose city, California",314210,3502,175835,4309,138375,4461
1600000US0668084,0668084,"San Leandro city, California",32580,1421,17626,1607,14954,1577
1600000US0668196,0668196,"San Marcos city, California",29636,2086,17379,1871,12257,1540
1600000US0668252,0668252,"San Mateo city, California",38499,1888,21109,1871,17390,1456
1600000US0668378,0668378,"San Ramon city, California",25017,1098,17813,1269,7204,885
1600000US0669000,0669000,"Santa Ana city, California",76284,2617,32054,2232,44230,2471
1600000US0669070,0669070,"Santa Barbara city, California",34423,1893,12743,1567,21680,1829
1600000US0669084,0669084,"Santa Clara city, California",43279,1840,18936,1833,24343,1679
1600000US0669088,0669088,"Santa Clarita city, California",59940,2093,41134,2090,18806,1833
1600000US0669196,0669196,"Santa Maria city, California",27198,1687,14078,1324,13120,1337
1600000US0670000,0670000,"Santa Monica city, California",48280,2243,11278,1451,37002,2513
1600000US0670098,0670098,"Santa Rosa city, California",64997,2421,33497,2195,31500,2492
1600000US0672016,0672016,"Simi Valley city, California",42958,1930,31236,2056,11722,1542
1600000US0673080,0673080,"South Gate city, California",23076,930,11755,1221,11321,1075
1600000US0673262,0673262,"South San Francisco city, California",19958,1536,12341,1267,7617,1138
1600000US0673430,0673430,"South Whittier CDP, California",15763,1421,9523,1056,6240,1066
1600000US0675000,0675000,"Stockton city, California",90883,2333,42961,2648,47922,2401
1600000US0677000,0677000,"Sunnyvale city, California",56034,2326,26264,1855,29770,2471
1600000US0678120,0678120,"Temecula city, California",31802,1675,20091,1461,11711,1417
1600000US0678582,0678582,"Thousand Oaks city, California",46716,1990,32439,1908,14277,1520
1600000US0680000,0680000,"Torrance city, California",56789,2072,30749,2175,26040,2393
1600000US0680238,0680238,"Tracy city, California",25150,1271,14861,1429,10289,1279
1600000US0680812,0680812,"Turlock city, California",23333,1527,11482,1645,11851,1384
1600000US0680854,0680854,"Tustin city, California",25415,1571,12357,1291,13058,1299
1600000US0681204,0681204,"Union City city, California",20006,1266,12237,1090,7769,1055
1600000US0681344,0681344,"Upland city, California",27452,1265,15681,1260,11771,1366
1600000US0681554,0681554,"Vacaville city, California",30325,2007,18647,1788,11678,1491
1600000US0681666,0681666,"Vallejo city, California",41895,1658,24766,1855,17129,1835
1600000US0682590,0682590,"Victorville city, California",31317,2586,17518,2214,13799,2208
1600000US0682954,0682954,"Visalia city, California",42999,1968,22702,2113,20297,2072
1600000US0682996,0682996,"Vista city, California",33065,1650,15993,1713,17072,1277
1600000US0683346,0683346,"Walnut Creek city, California",30189,1716,19690,1479,10499,1633
1600000US0684200,0684200,"West Covina city, California",30801,1549,19648,1542,11153,1224
1600000US0684550,0684550,"Westminster city, California",27154,1526,14512,1405,12642,1238
1600000US0685292,0685292,"Whittier city, California",27299,1444,16173,1291,11126,1126
1600000US0686832,0686832,"Yorba Linda city, California",21955,1061,18708,1201,3247,928
1600000US0686972,0686972,"Yuba City city, California",20950,1227,11244,1361,9706,1179
1600000US0803455,0803455,"Arvada city, Colorado",43575,1508,30779,1757,12796,1205
1600000US0804000,0804000,"Aurora city, Colorado",124381,2843,68524,2767,55857,2933
1600000US0807850,0807850,"Boulder city, Colorado",42307,1884,20126,1432,22181,2009
1600000US0812815,0812815,"Centennial city, Colorado",38514,1526,30932,1566,7582,1130
1600000US0816000,0816000,"Colorado Springs city, Colorado",169761,2607,99507,3551,70254,3015
1600000US0820000,0820000,"Denver city, Colorado",273050,3115,139192,4215,133858,4593
1600000US0827425,0827425,"Fort Collins city, Colorado",57908,2177,33286,1914,24622,1869
1600000US0832155,0832155,"Greeley city, Colorado",32954,1513,18659,1397,14295,1224
1600000US0836410,0836410,"Highlands Ranch CDP, Colorado",36087,1290,28612,1387,7475,1119
1600000US0843000,0843000,"Lakewood city, Colorado",61496,2139,35970,2097,25526,1897
1600000US0845970,0845970,"Longmont city, Colorado",33661,1551,21795,1309,11866,1394
1600000US0846465,0846465,"Loveland city, Colorado",30308,1622,18085,1844,12223,1552
1600000US0862000,0862000,"Pueblo city, Colorado",42204,1523,23268,1764,18936,2055
1600000US0877290,0877290,"Thornton city, Colorado",42336,1750,30351,1867,11985,1449
1600000US0883835,0883835,"Westminster city, Colorado",41668,1660,27271,1595,14397,1477
1600000US0908000,0908000,"Bridgeport city, Connecticut",48273,2315,18826,1618,29447,2328
1600000US0918430,0918430,"Danbury city, Connecticut",29237,1840,17653,1598,11584,1617
1600000US0937000,0937000,"Hartford city, Connecticut",46212,2087,10853,1185,35359,2177
1600000US0950370,0950370,"New Britain city, Connecticut",26998,1788,11146,1229,15852,1820
1600000US0952000,0952000,"New Haven city, Connecticut",49986,2458,14313,1569,35673,2164
1600000US0955990,0955990,"Norwalk city, Connecticut",32258,1778,19431,1749,12827,1656
1600000US0973000,0973000,"Stamford city, Connecticut",48169,2448,26021,2213,22148,2272
1600000US0980000,0980000,"Waterbury city, Connecticut",39856,2079,16157,1474,23699,1993
1600000US1077580,1077580,"Wilmington city, Delaware",27874,1551,12249,1346,15625,1642
1600000US1150000,1150000,"Washington city, District of Columbia",271651,3228,110513,3814,161138,4370
1600000US1200410,1200410,"Alafaya CDP, Florida",25459,2622,14920,2054,10539,2245
1600000US1207300,1207300,"Boca Raton city, Florida",37063,2016,26435,2032,10628,1606
1600000US1207875,1207875,"Boynton Beach city, Florida",30296,2082,20004,1992,10292,1467
1600000US1208150,1208150,"Brandon CDP, Florida",40219,2692,21538,1853,18681,2214
1600000US1210275,1210275,"Cape Coral city, Florida",57341,2510,39085,2337,18256,1797
1600000US1212875,1212875,"Clearwater city, Florida",46914,2491,27011,2045,19903,2040
1600000US1214400,1214400,"Coral Springs city, Florida",40545,1728,24737,1749,15808,1945
1600000US1216475,1216475,"Davie town, Florida",34918,1684,24803,1730,10115,1462
1600000US1216725,1216725,"Deerfield Beach city, Florida",31188,2089,19057,2245,12131,1609
1600000US1217200,1217200,"Deltona city, Florida",29265,2008,23097,2242,6168,1205
1600000US1224000,1224000,"Fort Lauderdale city, Florida",74085,3443,40275,2683,33810,2726
1600000US1224125,1224125,"Fort Myers city, Florida",21529,1939,9916,1489,11613,1425
1600000US1225175,1225175,"Gainesville city, Florida",50356,2479,18213,1694,32143,2501
1600000US1230000,1230000,"Hialeah city, Florida",70280,3086,31493,2108,38787,2672
1600000US1232000,1232000,"Hollywood city, Florida",54557,2376,31967,2376,22590,2069
1600000US1235000,1235000,"Jacksonville city, Florida",314537,4279,185785,4585,128752,5282
1600000US1236100,1236100,"Kendall CDP, Florida",26765,2023,17485,1538,9280,1580
1600000US1236950,1236950,"Kissimmee city, Florida",20476,1928,8854,1618,11622,2011
1600000US1238250,1238250,"Lakeland city, Florida",38532,1765,22178,1542,16354,1695
1600000US1239425,1239425,"Largo city, Florida",34234,2407,19659,2278,14575,1849
1600000US1239550,1239550,"Lauderhill city, Florida",22734,1581,11621,1406,11113,1479
1600000US1239925,1239925,"Lehigh Acres CDP, Florida",31492,2194,17654,1840,13838,1547
1600000US1243975,1243975,"Melbourne city, Florida",34639,1646,18552,1666,16087,1886
1600000US1245000,1245000,"Miami city, Florida",154556,4265,48305,2856,106251,4239
1600000US1245025,1245025,"Miami Beach city, Florida",43832,2253,15543,1533,28289,1953
1600000US1245060,1245060,"Miami Gardens city, Florida",31541,1755,20499,1869,11042,1304
1600000US1245975,1245975,"Miramar city, Florida",37734,2055,24791,2273,12943,2180
1600000US1253000,1253000,"Orlando city, Florida",103466,3494,36986,2380,66480,3468
1600000US1254000,1254000,"Palm Bay city, Florida",38221,2138,28801,2419,9420,1758
1600000US1254200,1254200,"Palm Coast city, Florida",27195,1777,22527,1900,4668,977
1600000US1255775,1255775,"Pembroke Pines city, Florida",54492,2672,40731,2952,13761,1856
1600000US1256825,1256825,"Pine Hills CDP, Florida",20157,2044,10903,1535,9254,1536
1600000US1257425,1257425,"Plantation city, Florida",32672,1907,22184,1822,10488,1498
1600000US1258050,1258050,"Pompano Beach city, Florida",41007,2579,20977,2050,20030,2005
1600000US1258715,1258715,"Port St. Lucie city, Florida",57077,2902,42154,2989,14923,2661
1600000US1260950,1260950,"Riverview CDP, Florida",25314,2021,17756,1876,7558,1488
1600000US1263000,1263000,"St. Petersburg city, Florida",107522,3682,61074,3442,46448,3207
1600000US1268350,1268350,"Spring Hill CDP, Florida",37949,1980,25974,1752,11975,1637
1600000US1269700,1269700,"Sunrise city, Florida",31800,2055,21265,1943,10535,1650
1600000US1270600,1270600,"Tallahassee city, Florida",75202,2591,29664,1804,45538,2422
1600000US1271000,1271000,"Tampa city, Florida",146193,3743,73109,3242,73084,3903
1600000US1272145,1272145,"Town 'n' Country CDP, Florida",29588,2321,16954,1805,12634,1611
1600000US1276582,1276582,"Weston city, Florida",21675,1227,15846,1637,5829,1306
1600000US1276600,1276600,"West Palm Beach city, Florida",40851,2664,19865,2114,20986,2135
1600000US1301052,1301052,"Albany city, Georgia",27502,1758,9883,1169,17619,1570
1600000US1303440,1303440,"Athens-Clarke County unified government (balance), Georgia",44046,1625,16642,1644,27404,2035
1600000US1304000,1304000,"Atlanta city, Georgia",185160,4633,79504,3271,105656,4117
1600000US1304204,1304204,"Augusta-Richmond County consolidated government (balance), Georgia",69075,2362,35104,2572,33971,2533
1600000US1319000,1319000,"Columbus city, Georgia",71861,1863,34600,2010,37261,2152
1600000US1342425,1342425,"Johns Creek city, Georgia",26791,1608,20775,2010,6016,1314
1600000US1349000,1349000,"Macon city, Georgia",31529,1965,13377,1322,18152,1623
1600000US1367284,1367284,"Roswell city, Georgia",35066,2281,23036,2078,12030,1584
1600000US1368516,1368516,"Sandy Springs city, Georgia",44444,2272,19996,1485,24448,2125
1600000US1369000,1369000,"Savannah city, Georgia",53017,2495,23526,1782,29491,2246
1600000US1380508,1380508,"Warner Robins city, Georgia",27032,1509,14308,1722,12724,1669
1600000US1571550,1571550,"Urban Honolulu CDP, Hawaii",129756,3037,53606,2412,76150,2850
1600000US1608830,1608830,"Boise City city, Idaho",87769,2581,54460,2770,33309,2755
1600000US1652120,1652120,"Meridian city, Idaho",28710,1904,21562,2320,7148,1805
1600000US1656260,1656260,"Nampa city, Idaho",28560,1647,17947,2220,10613,1613
1600000US1702154,1702154,"Arlington Heights village, Illinois",29613,1302,21944,1415,7669,1049
1600000US1703012,1703012,"Aurora city, Illinois",61958,2191,41504,2305,20454,2109
1600000US1706613,1706613,"Bloomington city, Illinois",30752,1416,19300,1275,11452,1300
1600000US1707133,1707133,"Bolingbrook village, Illinois",20352,1583,16681,1303,3671,1005
1600000US1712385,1712385,"Champaign city, Illinois",31325,1705,14733,1236,16592,1626
1600000US1714000,1714000,"Chicago city, Illinois",1030136,10542,441937,7463,588199,9888
1600000US1714351,1714351,"Cicero town, Illinois",22233,1198,11003,1163,11230,1600
1600000US1718823,1718823,"Decatur city, Illinois",30507,1483,19487,1249,11020,1280
1600000US1723074,1723074,"Elgin city, Illinois",33257,2171,22299,1976,10958,1653
1600000US1724582,1724582,"Evanston city, Illinois",28326,1611,16552,1590,11774,1321
1600000US1738570,1738570,"Joliet city, Illinois",48027,2125,33276,1927,14751,1637
1600000US1751622,1751622,"Naperville city, Illinois",49686,1811,36874,1671,12812,1458
1600000US1757225,1757225,"Palatine village, Illinois",25939,1725,16260,1480,9679,1518
1600000US1759000,1759000,"Peoria city, Illinois",47061,1654,24957,1834,22104,1636
1600000US1765000,1765000,"Rockford city, Illinois",58122,1860,32731,1644,25391,1834
1600000US1768003,1768003,"Schaumburg village, Illinois",32314,1836,19839,1603,12475,1584
1600000US1770122,1770122,"Skokie village, Illinois",21781,1543,16497,1442,5284,1176
1600000US1772000,1772000,"Springfield city, Illinois",49401,1416,31061,1543,18340,1701
1600000US1779293,1779293,"Waukegan city, Illinois",29835,1801,13623,1699,16212,2030
1600000US1805860,1805860,"Bloomington city, Indiana",29578,1874,10063,1145,19515,1884
1600000US1810342,1810342,"Carmel city, Indiana",30868,1607,24550,1450,6318,946
1600000US1822000,1822000,"Evansville city, Indiana",49611,1959,26114,1725,23497,1652
1600000US1823278,1823278,"Fishers town, Indiana",28519,1957,24473,2105,4046,882
1600000US1825000,1825000,"Fort Wayne city, Indiana",101860,2000,63018,2313,38842,2047
1600000US1827000,1827000,"Gary city, Indiana",30144,1623,16117,1447,14027,1243
1600000US1831000,1831000,"Hammond city, Indiana",28508,1765,16461,1675,12047,1567
1600000US1836003,1836003,"Indianapolis city (balance), Indiana",326395,4371,170963,4047,155432,4390
1600000US1840788,1840788,"Lafayette city, Indiana",29623,1323,12978,1239,16645,1775
1600000US1851876,1851876,"Muncie city, Indiana",28881,1613,14191,1283,14690,1376
1600000US1871000,1871000,"South Bend city, Indiana",40476,1883,23676,1894,16800,1448
1600000US1912000,1912000,"Cedar Rapids city, Iowa",53145,1670,35996,1625,17149,1559
1600000US1919000,1919000,"Davenport city, Iowa",40801,1326,25005,1545,15796,1369
1600000US1921000,1921000,"Des Moines city, Iowa",82095,2434,49216,2699,32879,2475
1600000US1938595,1938595,"Iowa City city, Iowa",29941,1320,12377,1417,17564,1242
1600000US1973335,1973335,"Sioux City city, Iowa",30982,1233,20312,1237,10670,1220
1600000US1982425,1982425,"Waterloo city, Iowa",29123,1275,18019,1126,11104,1332
1600000US2036000,2036000,"Kansas City city, Kansas",52588,1497,28376,1480,24212,1668
1600000US2038900,2038900,"Lawrence city, Kansas",34991,1672,16399,1529,18592,2050
1600000US2052575,2052575,"Olathe city, Kansas",45387,1718,32947,1659,12440,1260
1600000US2053775,2053775,"Overland Park city, Kansas",75038,1995,45873,2108,29165,2137
1600000US2071000,2071000,"Topeka city, Kansas",54304,1465,30003,1635,24301,1901
1600000US2079000,2079000,"Wichita city, Kansas",151213,2724,90175,2897,61038,2740
1600000US2146027,2146027,"Lexington-Fayette urban county, Kentucky",125138,2330,65348,2620,59790,2869
1600000US2148006,2148006,"Louisville/Jefferson County metro government (balance), Kentucky",247847,3782,147483,3778,100364,3730
1600000US2205000,2205000,"Baton Rouge city, Louisiana",88748,3157,44316,2551,44432,3185
1600000US2208920,2208920,"Bossier City city, Louisiana",25109,1323,14361,1387,10748,1443
1600000US2239475,2239475,"Kenner city, Louisiana",24845,1499,15153,1341,9692,1376
1600000US2240735,2240735,"Lafayette city, Louisiana",48569,2029,27378,1620,21191,1814
1600000US2241155,2241155,"Lake Charles city, Louisiana",30111,1404,15515,1345,14596,1612
1600000US2250115,2250115,"Metairie CDP, Louisiana",59686,2628,36376,2131,23310,2257
1600000US2255000,2255000,"New Orleans city, Louisiana",158354,2391,72001,2524,86353,2570
1600000US2270000,2270000,"Shreveport city, Louisiana",77784,2391,42376,2091,35408,2530
1600000US2360545,2360545,"Portland city, Maine",28026,1581,11612,1378,16414,1515
1600000US2404000,2404000,"Baltimore city, Maryland",244114,3964,112858,3450,131256,3997
1600000US2407125,2407125,"Bethesda CDP, Maryland",25478,1322,17540,1024,7938,888
1600000US2419125,2419125,"Columbia CDP, Maryland",39823,1987,26292,1996,13531,1857
1600000US2426000,2426000,"Ellicott City CDP, Maryland",24092,1464,18111,1112,5981,1217
1600000US2430325,2430325,"Frederick city, Maryland",27125,1125,13881,1398,13244,1396
1600000US2431175,2431175,"Gaithersburg city, Maryland",23932,1502,13436,1278,10496,1230
1600000US2432025,2432025,"Germantown CDP, Maryland",32198,2036,21422,1938,10776,1639
1600000US2432650,2432650,"Glen Burnie CDP, Maryland",25707,1767,15033,1537,10674,1724
1600000US2472450,2472450,"Silver Spring CDP, Maryland",29932,2034,11677,1345,18255,1898
1600000US2481175,2481175,"Waldorf CDP, Maryland",25267,1254,16885,1283,8382,1381
1600000US2507000,2507000,"Boston city, Massachusetts",251757,3144,84697,4204,167060,3923
1600000US2509000,2509000,"Brockton city, Massachusetts",31800,1668,17562,1412,14238,1698
1600000US2511000,2511000,"Cambridge city, Massachusetts",43140,2203,15570,1318,27570,2029
1600000US2523000,2523000,"Fall River city, Massachusetts",38846,1739,14404,1449,24442,1774
1600000US2524960,2524960,"Framingham CDP, Massachusetts",26519,1859,13535,1476,12984,1513
1600000US2534550,2534550,"Lawrence city, Massachusetts",24206,1541,6204,1052,18002,1515
1600000US2537000,2537000,"Lowell city, Massachusetts",38499,2434,15678,1823,22821,2059
1600000US2537490,2537490,"Lynn city, Massachusetts",32721,1472,14586,1323,18135,1486
1600000US2545000,2545000,"New Bedford city, Massachusetts",41489,1756,17018,1591,24471,1845
1600000US2545560,2545560,"Newton city, Massachusetts",32432,1606,21995,1553,10437,1370
1600000US2555745,2555745,"Quincy city, Massachusetts",40240,1945,17884,1763,22356,2001
1600000US2562535,2562535,"Somerville city, Massachusetts",32520,2036,11970,1630,20550,2148
1600000US2567000,2567000,"Springfield city, Massachusetts",55448,2059,26028,2205,29420,2238
1600000US2582000,2582000,"Worcester city, Massachusetts",67065,2313,27858,2174,39207,2272
1600000US2603000,2603000,"Ann Arbor city, Michigan",46560,1979,22633,1442,23927,1858
1600000US2621000,2621000,"Dearborn city, Michigan",29844,1369,19821,1306,10023,1380
1600000US2622000,2622000,"Detroit city, Michigan",255322,3879,127502,3459,127820,4488
1600000US2627440,2627440,"Farmington Hills city, Michigan",34201,1668,20472,1618,13729,1301
1600000US2629000,2629000,"Flint city, Michigan",40647,1902,24221,2157,16426,1832
1600000US2634000,2634000,"Grand Rapids city, Michigan",72284,2625,40109,2428,32175,2483
1600000US2642160,2642160,"Kalamazoo city, Michigan",27961,1650,12403,1320,15558,1699
1600000US2646000,2646000,"Lansing city, Michigan",49077,2076,22934,2000,26143,1892
1600000US2649000,2649000,"Livonia city, Michigan",37355,1225,30566,1296,6789,1068
1600000US2669035,2669035,"Rochester Hills city, Michigan",27470,1127,21134,1122,6336,964
1600000US2674900,2674900,"Southfield city, Michigan",31181,1674,15001,1084,16180,1418
1600000US2676460,2676460,"Sterling Heights city, Michigan",49365,1758,35595,2119,13770,1914
1600000US2680700,2680700,"Troy city, Michigan",30443,1137,22416,1152,8027,872
1600000US2684000,2684000,"Warren city, Michigan",54898,2002,39476,2086,15422,1480
1600000US2686000,2686000,"Westland city, Michigan",34655,1916,18860,1515,15795,1567
1600000US2688940,2688940,"Wyoming city, Michigan",27658,1687,18172,1492,9486,1566
1600000US2706616,2706616,"Bloomington city, Minnesota",37022,1668,25437,1474,11585,1252
1600000US2707966,2707966,"Brooklyn Park city, Minnesota",26035,1808,18375,1546,7660,1471
1600000US2717000,2717000,"Duluth city, Minnesota",36010,1350,21714,1216,14296,1039
1600000US2717288,2717288,"Eagan city, Minnesota",26155,1032,17354,1023,8801,865
1600000US2740166,2740166,"Maple Grove city, Minnesota",23733,1310,19808,1746,3925,1159
1600000US2743000,2743000,"Minneapolis city, Minnesota",168011,3768,79247,3337,88764,3401
1600000US2751730,2751730,"Plymouth city, Minnesota",30294,1548,21191,1499,9103,1170
1600000US2754880,2754880,"Rochester city, Minnesota",43712,1347,30708,1482,13004,1265
1600000US2756896,2756896,"St. Cloud city, Minnesota",24212,1522,12091,1076,12121,1310
1600000US2758000,2758000,"St. Paul city, Minnesota",110770,2632,55533,2409,55237,2746
1600000US2771428,2771428,"Woodbury city, Minnesota",24071,1127,18295,1371,5776,1194
1600000US2829700,2829700,"Gulfport city, Mississippi",28591,1657,13133,1462,15458,1469
1600000US2836000,2836000,"Jackson city, Mississippi",64218,2150,32352,2131,31866,2478
1600000US2915670,2915670,"Columbia city, Missouri",46626,1940,22055,1847,24571,1960
1600000US2935000,2935000,"Independence city, Missouri",49305,2161,29356,1734,19949,1986
1600000US2938000,2938000,"Kansas City city, Missouri",193340,4022,106713,4091,86627,4170
1600000US2941348,2941348,"Lee's Summit city, Missouri",33628,1578,25295,1767,8333,1307
1600000US2954074,2954074,"O'Fallon city, Missouri",29036,1268,23082,1701,5954,1387
1600000US2964082,2964082,"St. Charles city, Missouri",26477,1429,16648,1264,9829,1335
1600000US2964550,2964550,"St. Joseph city, Missouri",27774,1380,15832,1309,11942,1382
1600000US2965000,2965000,"St. Louis city, Missouri",140536,3412,61551,2784,78985,3232
1600000US2970000,2970000,"Springfield city, Missouri",72173,2131,31848,2103,40325,2133
1600000US3006550,3006550,"Billings city, Montana",44344,1575,26939,1586,17405,1417
1600000US3050200,3050200,"Missoula city, Montana",28920,1415,12691,1336,16229,1556
1600000US3128000,3128000,"Lincoln city, Nebraska",106874,1818,62182,2004,44692,2703
1600000US3137000,3137000,"Omaha city, Nebraska",171549,2617,97503,3081,74046,2553
1600000US3223770,3223770,"Enterprise CDP, Nevada",42026,2625,24049,2345,17977,1678
1600000US3231900,3231900,"Henderson city, Nevada",105373,2822,65621,2893,39752,2399
1600000US3240000,3240000,"Las Vegas city, Nevada",209439,5034,105088,3982,104351,4184
1600000US3251800,3251800,"North Las Vegas city, Nevada",66973,2714,34948,2421,32025,2363
1600000US3254600,3254600,"Paradise CDP, Nevada",85004,3504,34764,2571,50240,3213
1600000US3260600,3260600,"Reno city, Nevada",90507,2573,41131,2655,49376,2698
1600000US3268400,3268400,"Sparks city, Nevada",36050,1909,20568,1693,15482,1537
1600000US3268585,3268585,"Spring Valley CDP, Nevada",73457,3125,30968,2326,42489,3198
1600000US3271400,3271400,"Sunrise Manor CDP, Nevada",58222,2287,30284,1877,27938,2077
1600000US3345140,3345140,"Manchester city, New Hampshire",45632,1993,21000,1756,24632,2044
1600000US3350260,3350260,"Nashua city, New Hampshire",33630,1737,17887,1749,15743,1397
1600000US3403580,3403580,"Bayonne city, New Jersey",24687,1315,9334,1028,15353,1463
1600000US3410000,3410000,"Camden city, New Jersey",26533,1511,10183,1546,16350,1915
1600000US3413690,3413690,"Clifton city, New Jersey",27746,1322,17541,1497,10205,1399
1600000US3419390,3419390,"East Orange city, New Jersey",24450,1652,7321,1134,17129,1778
1600000US3421000,3421000,"Elizabeth city, New Jersey",39976,1797,9489,1419,30487,2023
1600000US3436000,3436000,"Jersey City city, New Jersey",97530,2501,26714,1978,70816,2818
1600000US3451000,3451000,"Newark city, New Jersey",93022,3012,20148,1807,72874,2892
1600000US3456550,3456550,"Passaic city, New Jersey",19749,1034,4627,798,15122,1122
1600000US3457000,3457000,"Paterson city, New Jersey",44262,1990,11932,1407,32330,1992
1600000US3473110,3473110,"Toms River CDP, New Jersey",33415,1817,26068,1900,7347,1452
1600000US3474000,3474000,"Trenton city, New Jersey",27633,1652,10955,1248,16678,1432
1600000US3474630,3474630,"Union City city, New Jersey",21810,1305,4257,944,17553,1131
1600000US3502000,3502000,"Albuquerque city, New Mexico",217856,3021,128121,3996,89735,3929
1600000US3539380,3539380,"Las Cruces city, New Mexico",39299,1837,21811,2065,17488,2006
1600000US3563460,3563460,"Rio Rancho city, New Mexico",32868,1225,25608,1655,7260,1320
1600000US3570500,3570500,"Santa Fe city, New Mexico",32027,1431,20704,1459,11323,1107
1600000US3601000,3601000,"Albany city, New York",41881,2137,14858,1727,27023,1974
1600000US3611000,3611000,"Buffalo city, New York",109511,2738,46208,2724,63303,2513
1600000US3615000,3615000,"Cheektowaga CDP, New York",34788,1837,22977,1549,11811,1544
1600000US3649121,3649121,"Mount Vernon city, New York",24180,1558,9628,932,14552,1661
1600000US3650617,3650617,"New Rochelle city, New York",30045,1599,14810,1545,15235,1622
1600000US3651000,3651000,"New York city, New York",3084861,9520,988094,11915,2096767,13497
1600000US3663000,3663000,"Rochester city, New York",86482,2881,32787,2099,53695,2542
1600000US3665508,3665508,"Schenectady city, New York",25054,1443,12793,1326,12261,1330
1600000US3673000,3673000,"Syracuse city, New York",55060,2151,21609,1779,33451,2105
1600000US3684000,3684000,"Yonkers city, New York",73972,2383,35632,2148,38340,2404
1600000US3702140,3702140,"Asheville city, North Carolina",37411,2105,17614,1714,19797,1693
1600000US3710740,3710740,"Cary town, North Carolina",57544,2086,38418,1947,19126,2144
1600000US3712000,3712000,"Charlotte city, North Carolina",299823,3587,158716,4014,141107,4246
1600000US3714100,3714100,"Concord city, North Carolina",27853,1357,17352,1369,10501,1334
1600000US3719000,3719000,"Durham city, North Carolina",99643,2144,48334,2371,51309,2368
1600000US3722920,3722920,"Fayetteville city, North Carolina",80010,1865,36885,1598,43125,2149
1600000US3725580,3725580,"Gastonia city, North Carolina",27706,1386,14322,1347,13384,1410
1600000US3728000,3728000,"Greensboro city, North Carolina",115731,2981,57769,2573,57962,2745
1600000US3728080,3728080,"Greenville city, North Carolina",35490,1533,12714,1497,22776,1681
1600000US3731400,3731400,"High Point city, North Carolina",40800,1925,21775,1520,19025,1766
1600000US3734200,3734200,"Jacksonville city, North Carolina",20666,1641,7090,1068,13576,1870
1600000US3755000,3755000,"Raleigh city, North Carolina",170554,4016,88301,3955,82253,3881
1600000US3774440,3774440,"Wilmington city, North Carolina",49069,2297,21973,1793,27096,2206
1600000US3775000,3775000,"Winston-Salem city, North Carolina",94074,2406,52599,2943,41475,2791
1600000US3807200,3807200,"Bismarck city, North Dakota",28761,1084,18793,1377,9968,1218
1600000US3825700,3825700,"Fargo city, North Dakota",49568,1828,21023,1395,28545,1910
1600000US3901000,3901000,"Akron city, Ohio",81989,2384,40914,2454,41075,2411
1600000US3912000,3912000,"Canton city, Ohio",30184,1899,15500,1610,14684,1650
1600000US3915000,3915000,"Cincinnati city, Ohio",133301,3442,50701,2461,82600,3514
1600000US3916000,3916000,"Cleveland city, Ohio",164400,3806,69845,2900,94555,3547
1600000US3918000,3918000,"Columbus city, Ohio",329894,4236,150389,4411,179505,5639
1600000US3921000,3921000,"Dayton city, Ohio",59009,2377,29916,1743,29093,2462
1600000US3944856,3944856,"Lorain city, Ohio",25029,1576,13913,1500,11116,1234
1600000US3961000,3961000,"Parma city, Ohio",33438,1636,26420,1510,7018,1027
1600000US3977000,3977000,"Toledo city, Ohio",118526,2949,63440,2632,55086,2791
1600000US3988000,3988000,"Youngstown city, Ohio",26384,1636,14779,1294,11605,1264
1600000US4009050,4009050,"Broken Arrow city, Oklahoma",37461,1261,28553,1369,8908,914
1600000US4023200,4023200,"Edmond city, Oklahoma",32956,1590,24203,1418,8753,1302
1600000US4041850,4041850,"Lawton city, Oklahoma",33750,1679,15227,1423,18523,1585
1600000US4052500,4052500,"Norman city, Oklahoma",44889,1926,23854,2002,21035,1711
1600000US4055000,4055000,"Oklahoma City city, Oklahoma",232102,3631,134949,3866,97153,4182
1600000US4075000,4075000,"Tulsa city, Oklahoma",162992,2104,83115,2039,79877,2156
1600000US4105350,4105350,"Beaverton city, Oregon",38494,2085,17238,1581,21256,2041
1600000US4105800,4105800,"Bend city, Oregon",30413,2089,16627,1861,13786,1842
1600000US4123850,4123850,"Eugene city, Oregon",65201,2453,33131,2204,32070,2517
1600000US4131250,4131250,"Gresham city, Oregon",38775,1884,19122,1841,19653,1802
1600000US4134100,4134100,"Hillsboro city, Oregon",34941,1807,17515,1641,17426,1708
1600000US4147000,4147000,"Medford city, Oregon",29201,1723,14369,1631,14832,1933
1600000US4159000,4159000,"Portland city, Oregon",253021,3082,134315,4422,118706,3952
1600000US4164900,4164900,"Salem city, Oregon",59637,2525,29796,2256,29841,2472
1600000US4202000,4202000,"Allentown city, Pennsylvania",39767,1938,18737,1756,21030,1894
1600000US4206088,4206088,"Bethlehem city, Pennsylvania",29325,1569,16553,1428,12772,1449
1600000US4224000,4224000,"Erie city, Pennsylvania",40914,1698,21762,1787,19152,1700
1600000US4260000,4260000,"Philadelphia city, Pennsylvania",582528,4670,297098,6044,285430,7014
1600000US4261000,4261000,"Pittsburgh city, Pennsylvania",130418,3608,64906,2225,65512,3218
1600000US4263624,4263624,"Reading city, Pennsylvania",29758,1684,12413,1530,17345,1553
1600000US4269000,4269000,"Scranton city, Pennsylvania",26682,1541,13868,1281,12814,1195
1600000US4419180,4419180,"Cranston city, Rhode Island",29837,1656,18599,1622,11238,1640
1600000US4454640,4454640,"Pawtucket city, Rhode Island",25592,1630,11322,1092,14270,1492
1600000US4459000,4459000,"Providence city, Rhode Island",60595,2552,21515,1764,39080,2754
1600000US4474300,4474300,"Warwick city, Rhode Island",35424,1468,25619,1501,9805,1333
1600000US4513330,4513330,"Charleston city, South Carolina",54364,2196,29929,2121,24435,2156
1600000US4516000,4516000,"Columbia city, South Carolina",44222,2186,20586,1637,23636,1608
1600000US4548535,4548535,"Mount Pleasant town, South Carolina",28482,1860,20731,1696,7751,1419
1600000US4550875,4550875,"North Charleston city, South Carolina",37024,2046,17824,1809,19200,1759
1600000US4561405,4561405,"Rock Hill city, South Carolina",26168,1444,14376,1262,11792,1374
1600000US4652980,4652980,"Rapid City city, South Dakota",28684,1116,16657,1253,12027,1364
1600000US4659020,4659020,"Sioux Falls city, South Dakota",66504,1548,41117,1738,25387,1950
1600000US4714000,4714000,"Chattanooga city, Tennessee",68523,2342,36133,2373,32390,2395
1600000US4715160,4715160,"Clarksville city, Tennessee",50911,2018,27492,1926,23419,1923
1600000US4727740,4727740,"Franklin city, Tennessee",26966,1269,19001,1743,7965,1479
1600000US4737640,4737640,"Jackson city, Tennessee",25638,1254,14248,1431,11390,1321
1600000US4738320,4738320,"Johnson City city, Tennessee",28172,1777,15743,1573,12429,1822
1600000US4740000,4740000,"Knoxville city, Tennessee",80265,2166,36964,2229,43301,2306
1600000US4748000,4748000,"Memphis city, Tennessee",250302,4332,120557,4381,129745,4668
1600000US4751560,4751560,"Murfreesboro city, Tennessee",45345,1910,23955,1792,21390,2152
1600000US4752006,4752006,"Nashville-Davidson metropolitan government (balance), Tennessee",251718,3567,136137,3742,115581,3901
1600000US4801000,4801000,"Abilene city, Texas",42519,1861,23982,1920,18537,1832
1600000US4801924,4801924,"Allen city, Texas",30231,1539,23228,1814,7003,1228
1600000US4803000,4803000,"Amarillo city, Texas",75280,1985,45199,2115,30081,2058
1600000US4804000,4804000,"Arlington city, Texas",135015,3825,76612,3141,58403,3956
1600000US4804462,4804462,"Atascocita CDP, Texas",19463,1887,15598,1840,3865,1225
1600000US4805000,4805000,"Austin city, Texas",349200,5054,157643,4175,191557,5874
1600000US4806128,4806128,"Baytown city, Texas",25976,1686,15886,1605,10090,1454
1600000US4807000,4807000,"Beaumont city, Texas",44792,2006,26735,1865,18057,2210
1600000US4810768,4810768,"Brownsville city, Texas",49682,2178,31040,2066,18642,1692
1600000US4810912,4810912,"Bryan city, Texas",28363,1562,12932,1468,15431,1805
1600000US4813024,4813024,"Carrollton city, Texas",46179,1997,27926,2098,18253,1721
1600000US4815976,4815976,"College Station city, Texas",35021,1694,11510,1085,23511,1766
1600000US4817000,4817000,"Corpus Christi city, Texas",115854,2158,65341,3227,50513,2978
1600000US4819000,4819000,"Dallas city, Texas",476733,6946,201168,5755,275565,5774
1600000US4819972,4819972,"Denton city, Texas",43673,2011,20845,1807,22828,2005
1600000US4822660,4822660,"Edinburg city, Texas",23344,2030,13311,1895,10033,1558
1600000US4824000,4824000,"El Paso city, Texas",219332,2888,129187,3985,90145,4037
1600000US4826232,4826232,"Flower Mound town, Texas",23504,957,20580,1077,2924,889
1600000US4827000,4827000,"Fort Worth city, Texas",269433,5649,152906,5256,116527,5184
1600000US4827684,4827684,"Frisco city, Texas",45378,1810,32642,1678,12736,1572
1600000US4829000,4829000,"Garland city, Texas",77958,2710,45974,2254,31984,2476
1600000US4830464,4830464,"Grand Prairie city, Texas",59638,2405,37103,2205,22535,2115
1600000US4832372,4832372,"Harlingen city, Texas",20298,1467,13618,1419,6680,1159
1600000US4835000,4835000,"Houston city, Texas",815266,7582,350611,8114,464655,9056
1600000US4837000,4837000,"Irving city, Texas",82361,2967,29604,2007,52757,2653
1600000US4839148,4839148,"Killeen city, Texas",43523,1865,20587,1968,22936,2023
1600000US4841464,4841464,"Laredo city, Texas",65685,1701,42508,1867,23177,1855
1600000US4841980,4841980,"League City city, Texas",34347,2185,23058,2152,11289,1924
1600000US4842508,4842508,"Lewisville city, Texas",36845,1857,15726,1460,21119,1722
1600000US4843888,4843888,"Longview city, Texas",30842,1351,16110,1256,14732,1265
1600000US4845000,4845000,"Lubbock city, Texas",88815,2421,48958,2246,39857,2816
1600000US4845384,4845384,"McAllen city, Texas",41352,2330,24773,1816,16579,1736
1600000US4845744,4845744,"McKinney city, Texas",48717,1967,31944,1984,16773,2050
1600000US4847892,4847892,"Mesquite city, Texas",47649,2079,26767,2081,20882,2331
1600000US4848072,4848072,"Midland city, Texas",43231,1678,25944,1963,17287,1760
1600000US4848768,4848768,"Mission city, Texas",25009,1842,16926,1689,8083,1799
1600000US4848804,4848804,"Missouri City city, Texas",22219,1653,17597,1957,4622,1383
1600000US4852356,4852356,"North Richland Hills city, Texas",26333,1571,15200,1531,11133,1334
1600000US4853388,4853388,"Odessa city, Texas",38870,1233,22843,1494,16027,1652
1600000US4856000,4856000,"Pasadena city, Texas",45715,1722,24865,1477,20850,1627
1600000US4856348,4856348,"Pearland city, Texas",35067,2106,26706,2265,8361,1952
1600000US4857200,4857200,"Pharr city, Texas",19788,1784,11494,1891,8294,1381
1600000US4858016,4858016,"Plano city, Texas",105977,2275,63109,2960,42868,2806
1600000US4861796,4861796,"Richardson city, Texas",38324,2012,23244,1447,15080,1630
1600000US4863500,4863500,"Round Rock city, Texas",37153,1816,23448,1570,13705,1714
1600000US4864472,4864472,"San Angelo city, Texas",37998,1460,22907,1547,15091,1689
1600000US4865000,4865000,"San Antonio city, Texas",493102,5088,262256,5647,230846,6747
1600000US4870808,4870808,"Sugar Land city, Texas",27493,1639,22349,1795,5144,1089
1600000US4872176,4872176,"Temple city, Texas",23926,1422,13885,1273,10041,1330
1600000US4872656,4872656,"The Woodlands CDP, Texas",36186,2381,26417,2466,9769,1844
1600000US4874144,4874144,"Tyler city, Texas",38261,1909,21017,1808,17244,1694
1600000US4875428,4875428,"Victoria city, Texas",23729,973,14694,1433,9035,1166
1600000US4876000,4876000,"Waco city, Texas",46626,1996,20727,1642,25899,2036
1600000US4879000,4879000,"Wichita Falls city, Texas",38748,1760,22022,1693,16726,1481
1600000US4943660,4943660,"Layton city, Utah",22086,1094,15913,1187,6173,1133
1600000US4955980,4955980,"Ogden city, Utah",29414,1280,15704,1182,13710,1261
1600000US4957300,4957300,"Orem city, Utah",26715,1372,15592,1313,11123,1396
1600000US4962470,4962470,"Provo city, Utah",31527,1504,13571,1239,17956,1481
1600000US4965330,4965330,"St. George city, Utah",26205,1511,17012,1527,9193,1413
1600000US4967000,4967000,"Salt Lake City city, Utah",73441,2561,35623,2243,37818,2353
1600000US4967440,4967440,"Sandy city, Utah",29484,1396,21301,1585,8183,1464
1600000US4982950,4982950,"West Jordan city, Utah",31566,1538,23545,1579,8021,1266
1600000US4983470,4983470,"West Valley City city, Utah",36344,1711,23805,1534,12539,1630
1600000US5101000,5101000,"Alexandria city, Virginia",65595,1972,29749,1700,35846,2274
1600000US5103000,5103000,"Arlington CDP, Virginia",98973,2218,43545,2313,55428,2573
1600000US5114440,5114440,"Centreville CDP, Virginia",24704,1685,17822,1340,6882,1348
1600000US5116000,5116000,"Chesapeake city, Virginia",80014,1950,56112,2182,23902,2059
1600000US5121088,5121088,"Dale City CDP, Virginia",19498,1510,13632,1189,5866,1205
1600000US5135000,5135000,"Hampton city, Virginia",53255,1462,29657,1736,23598,1827
1600000US5147672,5147672,"Lynchburg city, Virginia",29631,1105,14544,1168,15087,1360
1600000US5156000,5156000,"Newport News city, Virginia",67538,1794,34619,1764,32919,2015
1600000US5157000,5157000,"Norfolk city, Virginia",85484,2393,35580,2174,49904,2444
1600000US5164000,5164000,"Portsmouth city, Virginia",36012,1208,19919,1567,16093,1489
1600000US5167000,5167000,"Richmond city, Virginia",88110,2051,34719,2228,53391,2501
1600000US5168000,5168000,"Roanoke city, Virginia",42759,1384,22812,1813,19947,2102
1600000US5176432,5176432,"Suffolk city, Virginia",30989,906,21517,1141,9472,1065
1600000US5182000,5182000,"Virginia Beach city, Virginia",165428,2329,103818,2642,61610,3184
1600000US5303180,5303180,"Auburn city, Washington",29139,1933,16421,1593,12718,1570
1600000US5305210,5305210,"Bellevue city, Washington",52279,2150,29858,1879,22421,1822
1600000US5305280,5305280,"Bellingham city, Washington",34018,2132,15252,1549,18766,1699
1600000US5322640,5322640,"Everett city, Washington",41413,2286,18637,1731,22776,2096
1600000US5323515,5323515,"Federal Way city, Washington",32142,2034,18946,1827,13196,1664
1600000US5335275,5335275,"Kennewick city, Washington",27630,1447,16818,1634,10812,1595
1600000US5335415,5335415,"Kent city, Washington",43876,2471,23143,2313,20733,1876
1600000US5335940,5335940,"Kirkland city, Washington",35441,2065,23112,2152,12329,1526
1600000US5353545,5353545,"Pasco city, Washington",20288,969,13279,1460,7009,1294
1600000US5357745,5357745,"Renton city, Washington",38197,1943,18457,1857,19740,1776
1600000US5363000,5363000,"Seattle city, Washington",297920,5253,137740,4896,160180,4814
1600000US5367000,5367000,"Spokane city, Washington",86332,2218,46628,2484,39704,2275
1600000US5367167,5367167,"Spokane Valley city, Washington",37107,1953,22056,1563,15051,1588
1600000US5370000,5370000,"Tacoma city, Washington",81498,2589,40689,2328,40809,2302
1600000US5374060,5374060,"Vancouver city, Washington",64090,1888,30984,1537,33106,1899
1600000US5380010,5380010,"Yakima city, Washington",32560,1566,16381,1587,16179,1767
1600000US5502375,5502375,"Appleton city, Wisconsin",29236,1393,19140,1310,10096,1187
1600000US5522300,5522300,"Eau Claire city, Wisconsin",26665,1181,14245,1395,12420,1381
1600000US5531000,5531000,"Green Bay city, Wisconsin",42043,1763,23935,1509,18108,1560
1600000US5539225,5539225,"Kenosha city, Wisconsin",38324,1528,21057,1711,17267,1831
1600000US5548000,5548000,"Madison city, Wisconsin",107424,2937,50518,2401,56906,2715
1600000US5553000,5553000,"Milwaukee city, Wisconsin",231386,3458,97196,3105,134190,3836
1600000US5560500,5560500,"Oshkosh city, Wisconsin",26732,1359,14176,1230,12556,1327
1600000US5566000,5566000,"Racine city, Wisconsin",28878,1643,17386,1536,11492,1352
1600000US5584250,5584250,"Waukesha city, Wisconsin",28389,1378,16888,1380,11501,1244
