GEO.id,GEO.id2,GEO.display-label,HD01_VD01,HD02_VD01,HD01_VD02,HD02_VD02,HD01_VD03,HD02_VD03
1600000US0107000,0107000,"Birmingham city, Alabama",93205,3673,47459,2633,45746,3233
1600000US0135896,0135896,"Hoover city, Alabama",30049,2384,20472,1395,9577,1846
1600000US0137000,0137000,"Huntsville city, Alabama",70273,2775,41742,2626,28531,2561
1600000US0150000,0150000,"Mobile city, Alabama",78769,3064,45061,2988,33708,2647
1600000US0151000,0151000,"Montgomery city, Alabama",80947,2267,49998,2287,30949,2452
1600000US0177256,0177256,"Tuscaloosa city, Alabama",30881,1999,13741,1185,17140,1748
1600000US0203000,0203000,"Anchorage municipality, Alaska",102277,1392,62703,2273,39574,2247
1600000US0404720,0404720,"Avondale city, Arizona",18510,1832,13002,1517,5508,1431
1600000US0412000,0412000,"Chandler city, Arizona",81634,3916,57625,2856,24009,2747
1600000US0427400,0427400,"Gilbert town, Arizona",54836,2669,45022,2348,9814,2095
1600000US0427820,0427820,"Glendale city, Arizona",79828,4268,51223,3165,28605,2951
1600000US0446000,0446000,"Mesa city, Arizona",165509,5163,110364,4481,55145,3725
1600000US0454050,0454050,"Peoria city, Arizona",47840,3027,37503,2400,10337,1979
1600000US0455000,0455000,"Phoenix city, Arizona",503753,8335,298839,7056,204914,7532
1600000US0465000,0465000,"Scottsdale city, Arizona",95150,4226,68775,3483,26375,2744
1600000US0471510,0471510,"Surprise city, Arizona",34139,2859,30453,2633,3686,907
1600000US0473000,0473000,"Tempe city, Arizona",66893,4307,32160,2364,34733,3815
1600000US0477000,0477000,"Tucson city, Arizona",208342,4120,112815,3890,95527,3877
1600000US0485540,0485540,"Yuma city, Arizona",36694,2056,22405,2171,14289,1734
1600000US0523290,0523290,"Fayetteville city, Arkansas",29142,1604,12035,1356,17107,1462
1600000US0524550,0524550,"Fort Smith city, Arkansas",32958,1542,18222,1430,14736,1560
1600000US0541000,0541000,"Little Rock city, Arkansas",79042,2899,47206,2838,31836,2235
1600000US0600562,0600562,"Alameda city, California",29706,2451,15492,1838,14214,2361
1600000US0600884,0600884,"Alhambra city, California",27620,2434,12669,1934,14951,2033
1600000US0602000,0602000,"Anaheim city, California",95617,4271,48088,3207,47529,3924
1600000US0602252,0602252,"Antioch city, California",32575,2425,22955,2157,9620,2013
1600000US0602364,0602364,"Apple Valley town, California",21856,2304,16548,2019,5308,1396
1600000US0602553,0602553,"Arden-Arcade CDP, California",41421,2596,20494,1795,20927,2528
1600000US0603526,0603526,"Bakersfield city, California",94171,3630,59366,3465,34805,3052
1600000US0603666,0603666,"Baldwin Park city, California",19166,2266,12727,2227,6439,1236
1600000US0604982,0604982,"Bellflower city, California",23867,1887,9536,1328,14331,1796
1600000US0606000,0606000,"Berkeley city, California",44260,2358,19185,1898,25075,2307
1600000US0608786,0608786,"Buena Park city, California",22644,2166,14491,1509,8153,1752
1600000US0608954,0608954,"Burbank city, California",39388,2574,17850,1797,21538,2680
1600000US0611194,0611194,"Carlsbad city, California",36709,2264,26588,2054,10121,1490
1600000US0611530,0611530,"Carson city, California",25186,2267,20239,1961,4947,1495
1600000US0613014,0613014,"Chico city, California",29702,2022,10840,1178,18862,1793
1600000US0613210,0613210,"Chino city, California",18686,1968,13411,1642,5275,1569
1600000US0613214,0613214,"Chino Hills city, California",22146,1918,19276,1845,2870,876
1600000US0613392,0613392,"Chula Vista city, California",71438,4087,42006,2343,29432,3472
1600000US0613588,0613588,"Citrus Heights city, California",32494,2243,19265,1575,13229,2012
1600000US0614218,0614218,"Clovis city, California",27225,2216,17809,1736,9416,1693
1600000US0615044,0615044,"Compton city, California",24083,2589,13913,2169,10170,1824
1600000US0616000,0616000,"Concord city, California",42828,2840,26388,2014,16440,2532
1600000US0616350,0616350,"Corona city, California",47220,3402,33932,3118,13288,2146
1600000US0616532,0616532,"Costa Mesa city, California",39619,2950,13921,1044,25698,2870
1600000US0617918,0617918,"Daly City city, California",30911,2196,16896,1488,14015,1963
1600000US0619766,0619766,"Downey city, California",34853,3195,18076,1715,16777,3312
1600000US0620802,0620802,"East Los Angeles CDP, California",32135,2732,11473,1737,20662,2398
1600000US0621712,0621712,"El Cajon city, California",32220,2938,14958,1991,17262,2427
1600000US0622020,0622020,"Elk Grove city, California",38210,2614,32592,2199,5618,1257
1600000US0622230,0622230,"El Monte city, California",28912,3002,10693,1954,18219,2716
1600000US0622804,0622804,"Escondido city, California",43599,2896,27124,2324,16475,2043
1600000US0623182,0623182,"Fairfield city, California",32991,1973,19294,1703,13697,1640
1600000US0624477,0624477,"Florence-Graham CDP, California",15513,2532,6694,2082,8819,1643
1600000US0624638,0624638,"Folsom city, California",22846,2053,16286,1586,6560,1347
1600000US0624680,0624680,"Fontana city, California",38838,2813,28351,2187,10487,1718
1600000US0626000,0626000,"Fremont city, California",68287,3296,45809,2721,22478,2614
1600000US0627000,0627000,"Fresno city, California",154147,4519,77393,3717,76754,4365
1600000US0628000,0628000,"Fullerton city, California",48710,3105,27809,2448,20901,2457
1600000US0629000,0629000,"Garden Grove city, California",54338,3170,32684,2334,21654,2464
1600000US0630000,0630000,"Glendale city, California",70773,4349,27337,3103,43436,3586
1600000US0632548,0632548,"Hawthorne city, California",30747,3058,7938,1206,22809,2979
1600000US0633000,0633000,"Hayward city, California",44255,3479,25676,2296,18579,3022
1600000US0633182,0633182,"Hemet city, California",31115,3093,19775,2564,11340,1997
1600000US0633434,0633434,"Hesperia city, California",22982,2246,17496,2006,5486,1285
1600000US0636000,0636000,"Huntington Beach city, California",71653,3397,44005,2060,27648,2901
1600000US0636448,0636448,"Indio city, California",19087,2553,10747,1469,8340,2083
1600000US0636546,0636546,"Inglewood city, California",39125,3206,13863,2063,25262,3304
1600000US0636770,0636770,"Irvine city, California",66509,3424,37965,1836,28544,3053
1600000US0639496,0639496,"Lake Forest city, California",23840,2239,17694,1357,6146,1899
1600000US0639892,0639892,"Lakewood city, California",26719,2293,19855,1778,6864,1715
1600000US0640130,0640130,"Lancaster city, California",42245,3199,24872,2686,17373,2198
1600000US0641992,0641992,"Livermore city, California",29250,2321,20432,1892,8818,2142
1600000US0643000,0643000,"Long Beach city, California",163481,5556,66272,3453,97209,4835
1600000US0644000,0644000,"Los Angeles city, California",1284124,12819,512799,10128,771325,14584
1600000US0644574,0644574,"Lynwood city, California",14517,1839,7095,997,7422,1821
1600000US0646898,0646898,"Merced city, California",22387,1600,10430,1114,11957,1475
1600000US0648256,0648256,"Mission Viejo city, California",30662,2115,24950,1954,5712,986
1600000US0648354,0648354,"Modesto city, California",68167,2267,41113,2437,27054,2697
1600000US0649270,0649270,"Moreno Valley city, California",44380,3090,32966,2488,11414,1950
1600000US0649670,0649670,"Mountain View city, California",32015,2839,12581,1072,19434,2732
1600000US0650076,0650076,"Murrieta city, California",29058,2554,21862,2358,7196,1694
1600000US0650258,0650258,"Napa city, California",28617,1449,17451,1616,11166,1560
1600000US0651182,0651182,"Newport Beach city, California",35532,2366,22525,1697,13007,1967
1600000US0652526,0652526,"Norwalk city, California",27275,2443,18838,2003,8437,1557
1600000US0653000,0653000,"Oakland city, California",146282,5025,67543,3860,78739,4334
1600000US0653322,0653322,"Oceanside city, California",58608,3616,38091,2721,20517,2350
1600000US0653896,0653896,"Ontario city, California",44754,3281,26193,2443,18561,2803
1600000US0653980,0653980,"Orange city, California",44779,2750,28564,1844,16215,2238
1600000US0654652,0654652,"Oxnard city, California",45554,2754,27396,2359,18158,2291
1600000US0655156,0655156,"Palmdale city, California",38520,2885,27301,2411,11219,1991
1600000US0656000,0656000,"Pasadena city, California",52610,3242,24716,2215,27894,2933
1600000US0657792,0657792,"Pleasanton city, California",23272,1518,17286,1332,5986,982
1600000US0658072,0658072,"Pomona city, California",42015,3285,26204,2808,15811,2369
1600000US0659451,0659451,"Rancho Cucamonga city, California",49246,2865,32937,2232,16309,2231
1600000US0659920,0659920,"Redding city, California",35220,1728,19743,1227,15477,1598
1600000US0659962,0659962,"Redlands city, California",28596,2302,15338,1917,13258,1930
1600000US0660018,0660018,"Redondo Beach city, California",25318,1996,13747,1448,11571,1860
1600000US0660102,0660102,"Redwood City city, California",28454,2008,15576,1491,12878,1921
1600000US0660466,0660466,"Rialto city, California",25239,2310,17852,2073,7387,1561
1600000US0660620,0660620,"Richmond city, California",33603,2375,20416,1769,13187,1770
1600000US0662000,0662000,"Riverside city, California",93405,3924,52434,2887,40971,3442
1600000US0662938,0662938,"Roseville city, California",42278,2257,27513,2314,14765,1887
1600000US0664000,0664000,"Sacramento city, California",168782,5709,89196,4201,79586,4745
1600000US0664224,0664224,"Salinas city, California",42134,2439,20935,2326,21199,2295
1600000US0665000,0665000,"San Bernardino city, California",63366,3695,33896,3044,29470,2859
1600000US0665042,0665042,"San Buenaventura (Ventura) city, California",39303,2301,23820,1864,15483,2033
1600000US0666000,0666000,"San Diego city, California",466579,8160,239409,7009,227170,7821
1600000US0667000,0667000,"San Francisco city, California",322399,3073,122603,4341,199796,4863
1600000US0668000,0668000,"San Jose city, California",288339,5392,175828,6687,112511,5745
1600000US0668084,0668084,"San Leandro city, California",28889,2394,18327,1696,10562,1615
1600000US0668196,0668196,"San Marcos city, California",24573,2024,17292,2161,7281,1402
1600000US0668252,0668252,"San Mateo city, California",37861,2352,20953,1587,16908,2469
1600000US0669000,0669000,"Santa Ana city, California",68790,3691,35938,2633,32852,3032
1600000US0669070,0669070,"Santa Barbara city, California",35496,2481,15714,1728,19782,2156
1600000US0669084,0669084,"Santa Clara city, California",39246,2648,19913,1708,19333,2370
1600000US0669088,0669088,"Santa Clarita city, California",53182,2466,39373,2349,13809,1970
1600000US0669196,0669196,"Santa Maria city, California",26657,1803,15274,1467,11383,1692
1600000US0670000,0670000,"Santa Monica city, California",44598,2873,13518,1600,31080,2618
1600000US0670098,0670098,"Santa Rosa city, California",59485,3107,33232,2509,26253,2316
1600000US0672016,0672016,"Simi Valley city, California",37566,2321,29503,2204,8063,1173
1600000US0673080,0673080,"South Gate city, California",23639,2337,13368,1925,10271,1787
1600000US0675000,0675000,"Stockton city, California",91327,3595,49745,3407,41582,3046
1600000US0677000,0677000,"Sunnyvale city, California",52135,2807,25604,1882,26531,2236
1600000US0678120,0678120,"Temecula city, California",27110,2456,18275,1733,8835,2199
1600000US0678582,0678582,"Thousand Oaks city, California",43893,2699,32601,1860,11292,2321
1600000US0680000,0680000,"Torrance city, California",53921,2901,29403,2247,24518,2703
1600000US0680238,0680238,"Tracy city, California",24009,2369,17191,2122,6818,1510
1600000US0680812,0680812,"Turlock city, California",22935,2078,13256,1460,9679,1657
1600000US0680854,0680854,"Tustin city, California",29780,3215,14320,2294,15460,2527
1600000US0681204,0681204,"Union City city, California",18850,1973,12938,1279,5912,1784
1600000US0681344,0681344,"Upland city, California",25127,2341,14581,1389,10546,1939
1600000US0681554,0681554,"Vacaville city, California",28999,1938,18887,1359,10112,1861
1600000US0681666,0681666,"Vallejo city, California",40196,2639,27606,2359,12590,1921
1600000US0682590,0682590,"Victorville city, California",28889,2844,17832,2229,11057,2280
1600000US0682954,0682954,"Visalia city, California",36287,2150,21854,1402,14433,1877
1600000US0682996,0682996,"Vista city, California",28066,2172,14506,1458,13560,2002
1600000US0684200,0684200,"West Covina city, California",32999,2551,20062,1926,12937,2423
1600000US0684550,0684550,"Westminster city, California",27937,2587,16864,1974,11073,2058
1600000US0685292,0685292,"Whittier city, California",28188,2105,16409,1753,11779,1650
1600000US0803455,0803455,"Arvada city, Colorado",40708,1831,31707,1708,9001,1215
1600000US0804000,0804000,"Aurora city, Colorado",111072,3440,72929,2905,38143,2790
1600000US0807850,0807850,"Boulder city, Colorado",38898,1779,19151,1478,19747,1840
1600000US0812815,0812815,"Centennial city, Colorado",38078,1918,31372,1821,6706,1386
1600000US0816000,0816000,"Colorado Springs city, Colorado",155980,3654,95735,3553,60245,3961
1600000US0820000,0820000,"Denver city, Colorado",241579,3361,132045,4368,109534,4649
1600000US0827425,0827425,"Fort Collins city, Colorado",52144,2272,29090,1711,23054,1909
1600000US0832155,0832155,"Greeley city, Colorado",29657,1704,17219,1352,12438,1693
1600000US0836410,0836410,"Highlands Ranch CDP, Colorado",30805,1893,24736,1738,6069,1343
1600000US0843000,0843000,"Lakewood city, Colorado",62882,2764,39068,2370,23814,2323
1600000US0845970,0845970,"Longmont city, Colorado",29829,2098,19880,1602,9949,1521
1600000US0862000,0862000,"Pueblo city, Colorado",41978,1563,26525,1467,15453,1552
1600000US0877290,0877290,"Thornton city, Colorado",35753,2220,25699,1718,10054,1993
1600000US0883835,0883835,"Westminster city, Colorado",38185,1775,26542,1574,11643,1711
1600000US0908000,0908000,"Bridgeport city, Connecticut",49095,2732,23976,2141,25119,2303
1600000US0918430,0918430,"Danbury city, Connecticut",28192,2397,17052,1821,11140,1732
1600000US0937000,0937000,"Hartford city, Connecticut",43752,2499,11518,1572,32234,2798
1600000US0950370,0950370,"New Britain city, Connecticut",28155,2488,13081,1534,15074,2185
1600000US0952000,0952000,"New Haven city, Connecticut",46611,2680,13360,1550,33251,2744
1600000US0955990,0955990,"Norwalk city, Connecticut",32640,2469,23284,2256,9356,1620
1600000US0973000,0973000,"Stamford city, Connecticut",47412,2544,27343,2114,20069,2204
1600000US0980000,0980000,"Waterbury city, Connecticut",40470,2603,20303,1999,20167,2563
1600000US1077580,1077580,"Wilmington city, Delaware",26770,1861,13155,1378,13615,1616
1600000US1150000,1150000,"Washington city, District of Columbia",248213,2990,105518,3324,142695,3688
1600000US1207300,1207300,"Boca Raton city, Florida",34174,1994,24992,2052,9182,1547
1600000US1207875,1207875,"Boynton Beach city, Florida",24848,1964,18109,1619,6739,1627
1600000US1208150,1208150,"Brandon CDP, Florida",32840,2128,22154,1547,10686,1846
1600000US1210275,1210275,"Cape Coral city, Florida",54239,2905,39854,2706,14385,1944
1600000US1212875,1212875,"Clearwater city, Florida",49507,3032,30945,2289,18562,2533
1600000US1214400,1214400,"Coral Springs city, Florida",43265,2317,29356,1838,13909,1841
1600000US1216475,1216475,"Davie town, Florida",32619,2431,24358,1845,8261,1689
1600000US1216725,1216725,"Deerfield Beach city, Florida",32336,2460,21593,2109,10743,1879
1600000US1217200,1217200,"Deltona city, Florida",30862,2349,25466,2089,5396,1716
1600000US1224000,1224000,"Fort Lauderdale city, Florida",64681,3683,37504,2321,27177,2645
1600000US1225175,1225175,"Gainesville city, Florida",49301,2217,18967,1730,30334,1999
1600000US1230000,1230000,"Hialeah city, Florida",71504,4252,38145,3508,33359,3241
1600000US1232000,1232000,"Hollywood city, Florida",59170,2778,37656,2142,21514,2191
1600000US1235000,1235000,"Jacksonville city, Florida",313695,3922,201486,5291,112209,5183
1600000US1236100,1236100,"Kendall CDP, Florida",31812,2683,20369,2067,11443,1970
1600000US1238250,1238250,"Lakeland city, Florida",40522,2536,23199,2012,17323,2384
1600000US1239425,1239425,"Largo city, Florida",35274,2326,22979,1844,12295,1823
1600000US1243975,1243975,"Melbourne city, Florida",33704,2553,20702,2174,13002,1613
1600000US1245000,1245000,"Miami city, Florida",144706,5507,51489,3524,93217,5125
1600000US1245025,1245025,"Miami Beach city, Florida",46911,3440,18891,1885,28020,3114
1600000US1245060,1245060,"Miami Gardens city, Florida",31076,2741,22107,2321,8969,1688
1600000US1245975,1245975,"Miramar city, Florida",34700,2369,27840,2229,6860,1285
1600000US1253000,1253000,"Orlando city, Florida",94182,4653,37368,2598,56814,4331
1600000US1254000,1254000,"Palm Bay city, Florida",33653,2403,25502,2124,8151,1647
1600000US1255775,1255775,"Pembroke Pines city, Florida",58956,2959,45966,2334,12990,1982
1600000US1257425,1257425,"Plantation city, Florida",33172,2083,24920,1691,8252,1392
1600000US1258050,1258050,"Pompano Beach city, Florida",43641,2955,28443,2207,15198,2166
1600000US1258715,1258715,"Port St. Lucie city, Florida",48839,2862,39059,2513,9780,1845
1600000US1263000,1263000,"St. Petersburg city, Florida",108808,4203,68836,3549,39972,2999
1600000US1268350,1268350,"Spring Hill CDP, Florida",34731,1735,28749,1825,5982,1802
1600000US1269700,1269700,"Sunrise city, Florida",34275,2250,24962,1814,9313,1776
1600000US1270600,1270600,"Tallahassee city, Florida",68804,2596,33072,2109,35732,2471
1600000US1271000,1271000,"Tampa city, Florida",135433,4476,75492,3924,59941,4099
1600000US1272145,1272145,"Town 'n' Country CDP, Florida",31546,2301,21639,2086,9907,1472
1600000US1276582,1276582,"Weston city, Florida",20919,1785,16780,1466,4139,1160
1600000US1276600,1276600,"West Palm Beach city, Florida",40007,3110,21435,2290,18572,2600
1600000US1301052,1301052,"Albany city, Georgia",30240,1329,12617,1334,17623,1429
1600000US1303440,1303440,"Athens-Clarke County (balance), Georgia",41409,1271,16459,1301,24950,1365
1600000US1304000,1304000,"Atlanta city, Georgia",174130,5408,80605,4529,93525,5229
1600000US1304204,1304204,"Augusta-Richmond County (balance), Georgia",73739,1723,42138,2261,31601,2251
1600000US1319000,1319000,"Columbus city, Georgia",70926,1715,38723,2036,32203,2450
1600000US1349000,1349000,"Macon city, Georgia",37327,1873,18114,1673,19213,1994
1600000US1367284,1367284,"Roswell city, Georgia",33760,2184,23752,1795,10008,1791
1600000US1368516,1368516,"Sandy Springs CDP, Georgia",41371,2797,20340,1750,21031,2532
1600000US1369000,1369000,"Savannah city, Georgia",49672,2310,24838,2066,24834,2148
1600000US1517000,1517000,"Honolulu CDP, Hawaii",146070,3321,72842,2674,73228,3018
1600000US1608830,1608830,"Boise City city, Idaho",82587,2242,51816,2673,30771,2808
1600000US1656260,1656260,"Nampa city, Idaho",24541,1763,15342,1668,9199,1509
1600000US1702154,1702154,"Arlington Heights village, Illinois",30519,1775,25273,1707,5246,974
1600000US1703012,1703012,"Aurora city, Illinois",54416,3059,39099,2327,15317,2372
1600000US1706613,1706613,"Bloomington city, Illinois",25923,1657,16966,1181,8957,1378
1600000US1707133,1707133,"Bolingbrook village, Illinois",21922,1585,19346,1595,2576,807
1600000US1712385,1712385,"Champaign city, Illinois",29115,1530,13536,1214,15579,1394
1600000US1714000,1714000,"Chicago city, Illinois",1020605,11293,494985,10379,525620,11607
1600000US1714351,1714351,"Cicero town, Illinois",21359,2211,12879,2160,8480,1583
1600000US1718823,1718823,"Decatur city, Illinois",33109,1422,21755,1633,11354,1660
1600000US1723074,1723074,"Elgin city, Illinois",32208,2510,22207,1932,10001,1805
1600000US1724582,1724582,"Evanston city, Illinois",27259,1739,17341,1716,9918,1171
1600000US1738570,1738570,"Joliet city, Illinois",41764,2408,30987,2085,10777,1661
1600000US1751622,1751622,"Naperville city, Illinois",48655,2606,40210,2302,8445,1169
1600000US1757225,1757225,"Palatine village, Illinois",26757,2367,19242,1643,7515,1685
1600000US1759000,1759000,"Peoria city, Illinois",45053,1803,28604,1774,16449,1838
1600000US1765000,1765000,"Rockford city, Illinois",57071,2334,35470,1874,21601,1849
1600000US1768003,1768003,"Schaumburg village, Illinois",32014,2221,21929,1884,10085,1334
1600000US1772000,1772000,"Springfield city, Illinois",49056,1862,31759,1909,17297,1647
1600000US1779293,1779293,"Waukegan city, Illinois",28711,2090,14856,1458,13855,1956
1600000US1805860,1805860,"Bloomington city, Indiana",27557,1677,9606,1135,17951,1519
1600000US1822000,1822000,"Evansville city, Indiana",49215,1718,29520,1662,19695,1684
1600000US1825000,1825000,"Fort Wayne city, Indiana",91447,2433,58227,2675,33220,2479
1600000US1827000,1827000,"Gary city, Indiana",36702,2434,19179,1734,17523,2236
1600000US1831000,1831000,"Hammond city, Indiana",29028,1990,18473,1601,10555,1611
1600000US1836003,1836003,"Indianapolis city (balance), Indiana",326261,4748,201072,5093,125189,6324
1600000US1851876,1851876,"Muncie city, Indiana",26830,1301,14850,1227,11980,1342
1600000US1871000,1871000,"South Bend city, Indiana",41409,2109,25249,1691,16160,1931
1600000US1912000,1912000,"Cedar Rapids city, Iowa",51850,2209,35644,2110,16206,1411
1600000US1919000,1919000,"Davenport city, Iowa",38541,1707,26818,1550,11723,1273
1600000US1921000,1921000,"Des Moines city, Iowa",84463,2720,56991,3173,27472,2295
1600000US1973335,1973335,"Sioux City city, Iowa",31797,1098,20576,1272,11221,1235
1600000US1982425,1982425,"Waterloo city, Iowa",29743,1020,19427,1185,10316,1168
1600000US2036000,2036000,"Kansas City city, Kansas",53597,1847,35270,2122,18327,1986
1600000US2038900,2038900,"Lawrence city, Kansas",34459,1251,15592,1288,18867,1497
1600000US2052575,2052575,"Olathe city, Kansas",39223,2078,28497,1862,10726,1565
1600000US2053775,2053775,"Overland Park city, Kansas",64666,2479,43461,2080,21205,2191
1600000US2071000,2071000,"Topeka city, Kansas",53763,1583,33048,1922,20715,1761
1600000US2079000,2079000,"Wichita city, Kansas",144378,2580,87519,3067,56859,2963
1600000US2146027,2146027,"Lexington-Fayette, Kentucky",114548,2163,68782,2892,45766,2690
1600000US2148006,2148006,"Louisville/Jefferson County (balance), Kentucky",232883,4074,151016,4677,81867,4164
1600000US2205000,2205000,"Baton Rouge city, Louisiana",87465,3816,46171,2834,41294,3712
1600000US2239475,2239475,"Kenner city, Louisiana",25646,2145,15949,1786,9697,1582
1600000US2240735,2240735,"Lafayette city, Louisiana",45632,2492,26326,2065,19306,2116
1600000US2241155,2241155,"Lake Charles city, Louisiana",28885,1902,15425,1693,13460,2183
1600000US2250115,2250115,"Metairie CDP, Louisiana",57212,3257,38704,2516,18508,2368
1600000US2255000,2255000,"New Orleans city, Louisiana",163334,3173,81670,4470,81664,5577
1600000US2270000,2270000,"Shreveport city, Louisiana",77474,2458,47942,2590,29532,2235
1600000US2404000,2404000,"Baltimore city, Maryland",242978,3645,123532,4815,119446,5197
1600000US2419125,2419125,"Columbia CDP, Maryland",36539,1690,25556,1781,10983,1557
1600000US2472450,2472450,"Silver Spring CDP, Maryland",29369,1946,12077,1059,17292,1946
1600000US2507000,2507000,"Boston city, Massachusetts",233028,4830,83686,4245,149342,5189
1600000US2509000,2509000,"Brockton city, Massachusetts",31262,1846,17878,1591,13384,1387
1600000US2511000,2511000,"Cambridge city, Massachusetts",40898,2367,15529,1876,25369,1936
1600000US2523000,2523000,"Fall River city, Massachusetts",40839,3151,13994,1604,26845,3125
1600000US2534550,2534550,"Lawrence city, Massachusetts",27583,2182,10493,1752,17090,2313
1600000US2537000,2537000,"Lowell city, Massachusetts",37317,2416,15975,1675,21342,2785
1600000US2537490,2537490,"Lynn city, Massachusetts",30843,2521,15495,1522,15348,2375
1600000US2545000,2545000,"New Bedford city, Massachusetts",37125,2566,16929,1839,20196,2239
1600000US2545560,2545560,"Newton city, Massachusetts",33756,2199,23040,1992,10716,1763
1600000US2555745,2555745,"Quincy city, Massachusetts",37641,2669,21583,2231,16058,2190
1600000US2562535,2562535,"Somerville city, Massachusetts",31490,2782,10611,1673,20879,2291
1600000US2567000,2567000,"Springfield city, Massachusetts",57548,2194,27684,2061,29864,2209
1600000US2582000,2582000,"Worcester city, Massachusetts",63509,3624,30049,2646,33460,3286
1600000US2603000,2603000,"Ann Arbor city, Michigan",44651,2061,21098,1376,23553,1898
1600000US2613110,2613110,"Canton CDP, Michigan",30614,2050,23952,1750,6662,1001
1600000US2616510,2616510,"Clinton CDP, Michigan",41935,2449,30196,2277,11739,1569
1600000US2621000,2621000,"Dearborn city, Michigan",34340,2021,25385,1885,8955,1554
1600000US2622000,2622000,"Detroit city, Michigan",311234,6492,169755,6721,141479,6113
1600000US2627440,2627440,"Farmington Hills city, Michigan",33425,2130,22306,1759,11119,1620
1600000US2629000,2629000,"Flint city, Michigan",45054,2390,24184,1963,20870,2232
1600000US2634000,2634000,"Grand Rapids city, Michigan",75239,3155,46303,2587,28936,2751
1600000US2642160,2642160,"Kalamazoo city, Michigan",28533,1850,14046,1319,14487,1600
1600000US2646000,2646000,"Lansing city, Michigan",49552,2241,30486,1809,19066,1954
1600000US2649000,2649000,"Livonia city, Michigan",37560,1987,33589,1945,3971,829
1600000US2665440,2665440,"Pontiac city, Michigan",23513,2052,12495,1630,11018,1913
1600000US2669035,2669035,"Rochester Hills city, Michigan",26618,1634,21870,1355,4748,1155
1600000US2672818,2672818,"Shelby CDP, Michigan",25498,1666,20883,1512,4615,1023
1600000US2674900,2674900,"Southfield city, Michigan",32908,1916,18996,1260,13912,1729
1600000US2676460,2676460,"Sterling Heights city, Michigan",48528,2026,37255,1750,11273,1525
1600000US2680700,2680700,"Troy city, Michigan",31560,1573,24769,1316,6791,1022
1600000US2684000,2684000,"Warren city, Michigan",55326,2379,43900,2172,11426,1891
1600000US2684220,2684220,"Waterford CDP, Michigan",30589,1742,22671,1454,7918,1591
1600000US2686000,2686000,"Westland city, Michigan",32228,1990,20464,1350,11764,1662
1600000US2688940,2688940,"Wyoming city, Michigan",26416,1691,17936,1546,8480,1463
1600000US2706616,2706616,"Bloomington city, Minnesota",34470,1485,24450,1254,10020,1235
1600000US2707966,2707966,"Brooklyn Park city, Minnesota",24707,1704,18006,1358,6701,1183
1600000US2717000,2717000,"Duluth city, Minnesota",36116,1738,24437,1510,11679,1409
1600000US2743000,2743000,"Minneapolis city, Minnesota",156970,3875,83603,2641,73367,3702
1600000US2751730,2751730,"Plymouth city, Minnesota",26846,1529,20776,1129,6070,1186
1600000US2754880,2754880,"Rochester city, Minnesota",37710,1308,27639,1338,10071,1263
1600000US2756896,2756896,"St. Cloud city, Minnesota",25318,1593,13962,1097,11356,1717
1600000US2758000,2758000,"St. Paul city, Minnesota",107979,2911,63609,2279,44370,3044
1600000US2829700,2829700,"Gulfport city, Mississippi",26918,2418,16849,2100,10069,1822
1600000US2836000,2836000,"Jackson city, Mississippi",64404,2538,36477,2224,27927,2570
1600000US2915670,2915670,"Columbia city, Missouri",39624,1722,19483,1738,20141,1733
1600000US2935000,2935000,"Independence city, Missouri",48796,2817,34276,2205,14520,2133
1600000US2938000,2938000,"Kansas City city, Missouri",187448,3726,111574,3670,75874,4153
1600000US2941348,2941348,"Lee's Summit city, Missouri",31754,1777,25442,1883,6312,1158
1600000US2954074,2954074,"O'Fallon city, Missouri",23480,1636,21147,1683,2333,851
1600000US2964550,2964550,"St. Joseph city, Missouri",28868,1255,18893,1366,9975,1164
1600000US2965000,2965000,"St. Louis city, Missouri",141408,2913,69688,3342,71720,2883
1600000US2970000,2970000,"Springfield city, Missouri",67180,2193,35384,2146,31796,2184
1600000US3006550,3006550,"Billings city, Montana",40526,1248,25842,1455,14684,1443
1600000US3128000,3128000,"Lincoln city, Nebraska",97128,1600,58334,2254,38794,1821
1600000US3137000,3137000,"Omaha city, Nebraska",156292,2246,90058,2445,66234,2548
1600000US3231900,3231900,"Henderson city, Nevada",86924,3377,59256,2562,27668,2604
1600000US3240000,3240000,"Las Vegas city, Nevada",204688,5735,120635,4735,84053,4921
1600000US3251800,3251800,"North Las Vegas city, Nevada",52061,3384,34667,2590,17394,2596
1600000US3254600,3254600,"Paradise CDP, Nevada",85846,3622,39520,2120,46326,3041
1600000US3260600,3260600,"Reno city, Nevada",88118,2924,40467,2601,47651,2720
1600000US3268400,3268400,"Sparks city, Nevada",27400,1739,17438,1405,9962,1622
1600000US3268585,3268585,"Spring Valley CDP, Nevada",60588,3919,34688,2602,25900,3238
1600000US3271400,3271400,"Sunrise Manor CDP, Nevada",65177,3266,39184,2612,25993,3104
1600000US3345140,3345140,"Manchester city, New Hampshire",44354,1859,23187,1400,21167,1996
1600000US3350260,3350260,"Nashua city, New Hampshire",33489,2159,19339,1285,14150,1841
1600000US3410000,3410000,"Camden city, New Jersey",26397,2004,10726,1628,15671,2290
1600000US3413690,3413690,"Clifton city, New Jersey",29665,2069,17771,1653,11894,1858
1600000US3419390,3419390,"East Orange city, New Jersey",25423,2653,6877,2029,18546,2415
1600000US3420260,3420260,"Edison CDP, New Jersey",35065,2237,23626,1494,11439,1588
1600000US3421000,3421000,"Elizabeth city, New Jersey",40690,2822,14546,1906,26144,2847
1600000US3434440,3434440,"Irvington CDP, New Jersey",22321,2141,6485,1316,15836,2112
1600000US3436000,3436000,"Jersey City city, New Jersey",89572,4026,27100,2545,62472,4024
1600000US3451000,3451000,"Newark city, New Jersey",91927,4260,21295,2702,70632,4397
1600000US3456550,3456550,"Passaic city, New Jersey",20030,1691,5012,1035,15018,1716
1600000US3457000,3457000,"Paterson city, New Jersey",45183,2536,14923,1971,30260,2584
1600000US3473110,3473110,"Toms River CDP, New Jersey",33895,2216,29354,2028,4541,1026
1600000US3474000,3474000,"Trenton city, New Jersey",27075,1973,11372,1458,15703,1776
1600000US3474630,3474630,"Union City city, New Jersey",22123,2132,5449,1160,16674,1886
1600000US3502000,3502000,"Albuquerque city, New Mexico",208824,3267,130571,3582,78253,3969
1600000US3539380,3539380,"Las Cruces city, New Mexico",34005,1758,17785,1647,16220,1952
1600000US3563460,3563460,"Rio Rancho city, New Mexico",24612,1022,19671,1612,4941,1326
1600000US3570500,3570500,"Santa Fe city, New Mexico",27481,1691,17594,1293,9887,1411
1600000US3601000,3601000,"Albany city, New York",37436,1880,15964,1504,21472,1918
1600000US3611000,3611000,"Buffalo city, New York",117124,3786,48965,3082,68159,3608
1600000US3615000,3615000,"Cheektowaga CDP, New York",36058,2451,25714,2087,10344,1742
1600000US3649121,3649121,"Mount Vernon city, New York",24697,1949,8523,1147,16174,2121
1600000US3650617,3650617,"New Rochelle city, New York",26390,2070,15287,1624,11103,1636
1600000US3651000,3651000,"New York city, New York",3026196,10429,1002272,13917,2023924,14869
1600000US3663000,3663000,"Rochester city, New York",83010,3120,33722,2410,49288,2721
1600000US3673000,3673000,"Syracuse city, New York",57835,2385,23699,1600,34136,2253
1600000US3684000,3684000,"Yonkers city, New York",72374,3976,32926,2484,39448,3974
1600000US3702140,3702140,"Asheville city, North Carolina",35710,1993,19294,1446,16416,1843
1600000US3710740,3710740,"Cary town, North Carolina",39545,2295,28274,1778,11271,1914
1600000US3712000,3712000,"Charlotte city, North Carolina",249403,4718,150185,5048,99218,4975
1600000US3719000,3719000,"Durham city, North Carolina",82567,2677,42294,2792,40273,2682
1600000US3722920,3722920,"Fayetteville city, North Carolina",57143,3008,28768,2496,28375,2733
1600000US3725580,3725580,"Gastonia city, North Carolina",27861,1926,14648,1350,13213,1730
1600000US3728000,3728000,"Greensboro city, North Carolina",93221,3259,49128,2423,44093,3201
1600000US3728080,3728080,"Greenville city, North Carolina",26890,1886,10643,1392,16247,1837
1600000US3731400,3731400,"High Point city, North Carolina",39388,2516,23997,1777,15391,2024
1600000US3755000,3755000,"Raleigh city, North Carolina",138981,3458,74723,3681,64258,3603
1600000US3774440,3774440,"Wilmington city, North Carolina",44124,1910,23982,1664,20142,1706
1600000US3775000,3775000,"Winston-Salem city, North Carolina",79691,2603,45037,2464,34654,2855
1600000US3825700,3825700,"Fargo city, North Dakota",42619,1351,21213,1251,21406,1349
1600000US3901000,3901000,"Akron city, Ohio",85558,2846,51874,2890,33684,2812
1600000US3912000,3912000,"Canton city, Ohio",29977,1921,17059,1374,12918,1986
1600000US3915000,3915000,"Cincinnati city, Ohio",136949,3852,57851,3419,79098,4111
1600000US3916000,3916000,"Cleveland city, Ohio",177817,4347,82751,3572,95066,4330
1600000US3918000,3918000,"Columbus city, Ohio",301325,4568,160324,4624,141001,4077
1600000US3921000,3921000,"Dayton city, Ohio",59914,2774,31687,2057,28227,2771
1600000US3944856,3944856,"Lorain city, Ohio",27048,1811,16699,1526,10349,1865
1600000US3961000,3961000,"Parma city, Ohio",32296,1754,25161,1509,7135,1266
1600000US3977000,3977000,"Toledo city, Ohio",120970,3382,72570,3042,48400,3417
1600000US3988000,3988000,"Youngstown city, Ohio",28228,1714,17178,1515,11050,1367
1600000US4009050,4009050,"Broken Arrow city, Oklahoma",30871,1880,24805,1796,6066,1082
1600000US4023200,4023200,"Edmond city, Oklahoma",28143,1594,19729,1410,8414,1348
1600000US4041850,4041850,"Lawton city, Oklahoma",31726,1624,16600,1409,15126,1594
1600000US4052500,4052500,"Norman city, Oklahoma",43127,1762,23833,1710,19294,1641
1600000US4055000,4055000,"Oklahoma City city, Oklahoma",216838,3962,130468,4220,86370,3694
1600000US4075000,4075000,"Tulsa city, Oklahoma",160322,3718,89551,3058,70771,3245
1600000US4105350,4105350,"Beaverton city, Oregon",32175,2406,17164,1645,15011,1864
1600000US4105800,4105800,"Bend city, Oregon",29548,1466,17537,1447,12011,1696
1600000US4123850,4123850,"Eugene city, Oregon",63312,2272,32676,2233,30636,2193
1600000US4131250,4131250,"Gresham city, Oregon",37136,2330,19349,1638,17787,2104
1600000US4134100,4134100,"Hillsboro city, Oregon",29519,1966,14539,1337,14980,2033
1600000US4147000,4147000,"Medford city, Oregon",28978,1876,15788,1549,13190,1847
1600000US4159000,4159000,"Portland city, Oregon",228167,3632,129055,4085,99112,3525
1600000US4164900,4164900,"Salem city, Oregon",55425,2794,32013,2126,23412,2478
1600000US4202000,4202000,"Allentown city, Pennsylvania",42918,2319,21778,2115,21140,2184
1600000US4206088,4206088,"Bethlehem city, Pennsylvania",28606,1657,17178,1453,11428,1264
1600000US4224000,4224000,"Erie city, Pennsylvania",38872,2189,21937,1719,16935,2154
1600000US4260000,4260000,"Philadelphia city, Pennsylvania",565433,5629,320641,7022,244792,8317
1600000US4261000,4261000,"Pittsburgh city, Pennsylvania",136309,3975,72803,3636,63506,3539
1600000US4263624,4263624,"Reading city, Pennsylvania",30789,1617,14946,1472,15843,2001
1600000US4269000,4269000,"Scranton city, Pennsylvania",29367,1801,15320,1040,14047,1824
1600000US4419180,4419180,"Cranston city, Rhode Island",30476,1567,21121,1359,9355,1323
1600000US4454640,4454640,"Pawtucket city, Rhode Island",29232,2018,14247,1653,14985,1951
1600000US4459000,4459000,"Providence city, Rhode Island",59880,3029,23578,2305,36302,2500
1600000US4474300,4474300,"Warwick city, Rhode Island",35995,1296,27284,1387,8711,1347
1600000US4513330,4513330,"Charleston city, South Carolina",47985,2581,25349,2313,22636,2052
1600000US4516000,4516000,"Columbia city, South Carolina",42967,2935,20906,1688,22061,2600
1600000US4550875,4550875,"North Charleston city, South Carolina",29475,2265,14299,1362,15176,1966
1600000US4659020,4659020,"Sioux Falls city, South Dakota",57108,1352,35942,1571,21166,1578
1600000US4714000,4714000,"Chattanooga city, Tennessee",62655,2659,35171,2303,27484,2781
1600000US4715160,4715160,"Clarksville city, Tennessee",40703,2071,25667,1879,15036,1565
1600000US4740000,4740000,"Knoxville city, Tennessee",80153,3092,41314,2602,38839,2760
1600000US4748000,4748000,"Memphis city, Tennessee",261983,4867,142030,3998,119953,4329
1600000US4751560,4751560,"Murfreesboro city, Tennessee",36199,1723,17104,1540,19095,1955
1600000US4752006,4752006,"Nashville-Davidson (balance), Tennessee",233588,3484,132396,4420,101192,4310
1600000US4801000,4801000,"Abilene city, Texas",42827,1368,24617,1523,18210,1644
1600000US4801924,4801924,"Allen city, Texas",22287,1587,18638,1346,3649,1066
1600000US4803000,4803000,"Amarillo city, Texas",69103,1777,45335,2317,23768,2585
1600000US4804000,4804000,"Arlington city, Texas",126239,4983,72967,3657,53272,3897
1600000US4805000,4805000,"Austin city, Texas",289688,4830,139317,4436,150371,5582
1600000US4806128,4806128,"Baytown city, Texas",23219,1930,14596,1524,8623,1458
1600000US4807000,4807000,"Beaumont city, Texas",43256,2485,23816,1841,19440,2292
1600000US4810768,4810768,"Brownsville city, Texas",47048,2254,29460,2066,17588,2097
1600000US4810912,4810912,"Bryan city, Texas",22631,1513,11950,1327,10681,1638
1600000US4813024,4813024,"Carrollton city, Texas",41587,2944,26171,1979,15416,2391
1600000US4815976,4815976,"College Station city, Texas",28991,1702,9188,1032,19803,1831
1600000US4817000,4817000,"Corpus Christi city, Texas",103159,2396,62338,3063,40821,2816
1600000US4819000,4819000,"Dallas city, Texas",443764,7812,203755,6513,240009,9082
1600000US4819972,4819972,"Denton city, Texas",35661,2308,17288,1813,18373,2147
1600000US4824000,4824000,"El Paso city, Texas",193137,3509,121533,3477,71604,4295
1600000US4827000,4827000,"Fort Worth city, Texas",218999,5674,127912,4234,91087,4495
1600000US4827684,4827684,"Frisco city, Texas",23559,1794,17319,1391,6240,1428
1600000US4829000,4829000,"Garland city, Texas",78998,3811,51131,2895,27867,3245
1600000US4830464,4830464,"Grand Prairie city, Texas",47620,3296,32435,2361,15185,2496
1600000US4835000,4835000,"Houston city, Texas",733101,10612,350459,6593,382642,10028
1600000US4837000,4837000,"Irving city, Texas",76773,4198,30668,2224,46105,4011
1600000US4839148,4839148,"Killeen city, Texas",37823,2233,17982,1820,19841,2050
1600000US4841464,4841464,"Laredo city, Texas",56247,1449,33832,2392,22415,2318
1600000US4842508,4842508,"Lewisville city, Texas",31142,2329,16410,1497,14732,2012
1600000US4843888,4843888,"Longview city, Texas",30263,1580,17806,1617,12457,1522
1600000US4845000,4845000,"Lubbock city, Texas",81291,2477,43796,2475,37495,2740
1600000US4845384,4845384,"McAllen city, Texas",38830,3235,22487,1910,16343,2868
1600000US4845744,4845744,"McKinney city, Texas",32214,2263,23025,1836,9189,1538
1600000US4847892,4847892,"Mesquite city, Texas",44192,2561,31041,2208,13151,2125
1600000US4848072,4848072,"Midland city, Texas",38881,1516,24466,1719,14415,1852
1600000US4848804,4848804,"Missouri City city, Texas",17633,1607,15622,1476,2011,681
1600000US4853388,4853388,"Odessa city, Texas",35040,1542,24277,1568,10763,1265
1600000US4856000,4856000,"Pasadena city, Texas",48230,2659,27143,2054,21087,2195
1600000US4858016,4858016,"Plano city, Texas",90813,3756,58960,2796,31853,3318
1600000US4861796,4861796,"Richardson city, Texas",40773,3037,26767,1776,14006,2343
1600000US4863500,4863500,"Round Rock city, Texas",26424,1820,17646,1408,8778,1593
1600000US4864472,4864472,"San Angelo city, Texas",34141,1359,21892,1571,12249,1399
1600000US4865000,4865000,"San Antonio city, Texas",426227,5173,258507,5328,167720,5510
1600000US4870808,4870808,"Sugar Land city, Texas",20702,1570,17851,1532,2851,917
1600000US4872656,4872656,"The Woodlands CDP, Texas",24516,1711,19451,1635,5065,1322
1600000US4874144,4874144,"Tyler city, Texas",34303,1786,18103,1671,16200,2040
1600000US4876000,4876000,"Waco city, Texas",41354,2106,19907,1793,21447,1975
1600000US4879000,4879000,"Wichita Falls city, Texas",37735,1735,22924,1659,14811,1448
1600000US4955980,4955980,"Ogden city, Utah",29509,1422,18205,1419,11304,1629
1600000US4957300,4957300,"Orem city, Utah",25161,1714,15390,1241,9771,1617
1600000US4962470,4962470,"Provo city, Utah",31795,1919,13634,1356,18161,1670
1600000US4967000,4967000,"Salt Lake City city, Utah",75028,2860,38947,2104,36081,2546
1600000US4967440,4967440,"Sandy city, Utah",26712,2215,22421,2239,4291,819
1600000US4982950,4982950,"West Jordan city, Utah",27875,1756,22370,1428,5505,1561
1600000US4983470,4983470,"West Valley City city, Utah",35843,2252,23997,2060,11846,1737
1600000US5101000,5101000,"Alexandria city, Virginia",64054,1340,27807,2009,36247,2193
1600000US5103000,5103000,"Arlington CDP, Virginia",84133,1936,41476,2503,42657,2319
1600000US5116000,5116000,"Chesapeake city, Virginia",77821,731,56894,1979,20927,1967
1600000US5121088,5121088,"Dale City CDP, Virginia",22175,1890,17978,1820,4197,1267
1600000US5135000,5135000,"Hampton city, Virginia",55244,1154,33768,1722,21476,1568
1600000US5147672,5147672,"Lynchburg city, Virginia",25577,1209,16106,1132,9471,1177
1600000US5156000,5156000,"Newport News city, Virginia",73237,1253,39552,2431,33685,2387
1600000US5157000,5157000,"Norfolk city, Virginia",86306,1858,39718,2622,46588,2128
1600000US5164000,5164000,"Portsmouth city, Virginia",37532,1620,24033,1389,13499,1427
1600000US5167000,5167000,"Richmond city, Virginia",82199,1762,37294,2256,44905,2628
1600000US5168000,5168000,"Roanoke city, Virginia",42176,1349,25625,1789,16551,1621
1600000US5176432,5176432,"Suffolk city, Virginia",29414,514,21797,1136,7617,1009
1600000US5182000,5182000,"Virginia Beach city, Virginia",161353,2062,107472,3388,53881,3358
1600000US5305210,5305210,"Bellevue city, Washington",48998,2369,29553,1718,19445,2202
1600000US5305280,5305280,"Bellingham city, Washington",32385,1779,15002,1521,17383,1804
1600000US5322640,5322640,"Everett city, Washington",38239,2238,17893,1453,20346,1985
1600000US5323515,5323515,"Federal Way city, Washington",31861,2629,19053,2172,12808,2254
1600000US5335415,5335415,"Kent city, Washington",32998,2242,17164,1612,15834,2155
1600000US5363000,5363000,"Seattle city, Washington",261433,5335,130552,4153,130881,4563
1600000US5367000,5367000,"Spokane city, Washington",85594,2830,47459,2135,38135,2727
1600000US5367167,5367167,"Spokane Valley city, Washington",35542,2233,23608,2155,11934,1584
1600000US5370000,5370000,"Tacoma city, Washington",78806,2810,41222,2217,37584,2843
1600000US5374060,5374060,"Vancouver city, Washington",63693,2614,34484,2431,29209,2801
1600000US5380010,5380010,"Yakima city, Washington",30266,1567,16428,1149,13838,1404
1600000US5502375,5502375,"Appleton city, Wisconsin",28753,1342,22015,1475,6738,1108
1600000US5531000,5531000,"Green Bay city, Wisconsin",41823,1770,23204,1643,18619,1820
1600000US5539225,5539225,"Kenosha city, Wisconsin",36110,1356,23229,1451,12881,1426
1600000US5548000,5548000,"Madison city, Wisconsin",93124,2962,45020,2400,48104,2534
1600000US5553000,5553000,"Milwaukee city, Wisconsin",228861,4220,113122,4433,115739,4167
1600000US5566000,5566000,"Racine city, Wisconsin",31391,1525,19137,1485,12254,1489
1600000US5584250,5584250,"Waukesha city, Wisconsin",26752,1447,15925,1201,10827,1225
