GEO.id,GEO.id2,GEO.display-label,HD01_VD01,HD02_VD01,HD01_VD02,HD02_VD02,HD01_VD03,HD02_VD03
1600000US0107000,0107000,"Birmingham city, Alabama",98068,3348,48316,2594,49752,3112
1600000US0121184,0121184,"Dothan city, Alabama",25087,893,15547,795,9540,723
1600000US0135896,0135896,"Hoover city, Alabama",27524,1452,19913,1603,7611,1147
1600000US0137000,0137000,"Huntsville city, Alabama",75737,2299,46125,2063,29612,2060
1600000US0150000,0150000,"Mobile city, Alabama",78891,2711,42835,2285,36056,2464
1600000US0151000,0151000,"Montgomery city, Alabama",81397,2788,49848,2435,31549,2953
1600000US0177256,0177256,"Tuscaloosa city, Alabama",35106,2198,17621,1400,17485,1867
1600000US0203000,0203000,"Anchorage municipality, Alaska",104556,1780,64697,2353,39859,2804
1600000US0404720,0404720,"Avondale city, Arizona",23001,2242,14806,2130,8195,1337
1600000US0412000,0412000,"Chandler city, Arizona",83445,2825,54878,2993,28567,2308
1600000US0427400,0427400,"Gilbert town, Arizona",68115,2088,48309,2549,19806,2034
1600000US0427820,0427820,"Glendale city, Arizona",81200,3841,52690,3415,28510,2454
1600000US0446000,0446000,"Mesa city, Arizona",164380,3975,109543,3989,54837,3479
1600000US0454050,0454050,"Peoria city, Arizona",56211,2652,41918,2696,14293,1969
1600000US0455000,0455000,"Phoenix city, Arizona",516655,8138,305306,7869,211349,6721
1600000US0465000,0465000,"Scottsdale city, Arizona",102533,3716,73031,3629,29502,2672
1600000US0471510,0471510,"Surprise city, Arizona",31517,1587,25079,1747,6438,1039
1600000US0473000,0473000,"Tempe city, Arizona",64875,3239,30226,2227,34649,3212
1600000US0477000,0477000,"Tucson city, Arizona",198211,4207,108385,3931,89826,3433
1600000US0485540,0485540,"Yuma city, Arizona",32678,1919,18344,1646,14334,1910
1600000US0523290,0523290,"Fayetteville city, Arkansas",30779,1746,13785,1770,16994,1667
1600000US0524550,0524550,"Fort Smith city, Arkansas",34066,2177,19012,1823,15054,1884
1600000US0535710,0535710,"Jonesboro city, Arkansas",26018,1281,12484,1370,13534,1304
1600000US0541000,0541000,"Little Rock city, Arkansas",80056,2496,43895,2593,36161,2855
1600000US0566080,0566080,"Springdale city, Arkansas",21963,1350,12187,1337,9776,1257
1600000US0600562,0600562,"Alameda city, California",28869,1786,13473,1431,15396,1396
1600000US0600884,0600884,"Alhambra city, California",28720,1832,12389,1705,16331,1597
1600000US0602000,0602000,"Anaheim city, California",98703,3096,47706,2779,50997,2844
1600000US0602252,0602252,"Antioch city, California",30390,1853,19083,2064,11307,1285
1600000US0602364,0602364,"Apple Valley town, California",21656,1447,15792,1502,5864,985
1600000US0602553,0602553,"Arden-Arcade CDP, California",41542,2666,19633,1673,21909,2094
1600000US0603526,0603526,"Bakersfield city, California",101410,2990,58114,2931,43296,3280
1600000US0603666,0603666,"Baldwin Park city, California",17115,1388,10826,1276,6289,1169
1600000US0604982,0604982,"Bellflower city, California",20962,1396,8062,1063,12900,1283
1600000US0606000,0606000,"Berkeley city, California",39600,2212,17660,1582,21940,2074
1600000US0608786,0608786,"Buena Park city, California",22191,1546,12284,1643,9907,1057
1600000US0608954,0608954,"Burbank city, California",39535,2197,17872,1614,21663,1951
1600000US0611194,0611194,"Carlsbad city, California",39020,1662,27209,1687,11811,1373
1600000US0611530,0611530,"Carson city, California",26097,1453,19999,1667,6098,1027
1600000US0613014,0613014,"Chico city, California",31256,1709,13621,1276,17635,1548
1600000US0613210,0613210,"Chino city, California",21544,1379,14800,1477,6744,1126
1600000US0613214,0613214,"Chino Hills city, California",20674,1148,15941,1569,4733,1077
1600000US0613392,0613392,"Chula Vista city, California",67367,2399,38993,1882,28374,2243
1600000US0613588,0613588,"Citrus Heights city, California",33422,1678,20142,1904,13280,1475
1600000US0614218,0614218,"Clovis city, California",32896,1440,20753,1708,12143,1464
1600000US0615044,0615044,"Compton city, California",21748,1337,11765,1388,9983,1247
1600000US0616000,0616000,"Concord city, California",42648,2061,26682,2383,15966,1476
1600000US0616350,0616350,"Corona city, California",40818,1632,28254,1760,12564,1435
1600000US0616532,0616532,"Costa Mesa city, California",37093,2461,16069,1654,21024,1918
1600000US0617918,0617918,"Daly City city, California",30381,2042,18184,1802,12197,1773
1600000US0619766,0619766,"Downey city, California",30743,1901,15463,1332,15280,1746
1600000US0620802,0620802,"East Los Angeles CDP, California",31210,2297,10661,1506,20549,2100
1600000US0621712,0621712,"El Cajon city, California",30563,1918,12771,1671,17792,1534
1600000US0622020,0622020,"Elk Grove city, California",40211,1546,30089,2223,10122,1573
1600000US0622230,0622230,"El Monte city, California",27326,1569,11265,1263,16061,1560
1600000US0622804,0622804,"Escondido city, California",43945,2474,24032,1644,19913,2081
1600000US0623182,0623182,"Fairfield city, California",33044,1592,20562,1883,12482,1671
1600000US0624638,0624638,"Folsom city, California",23116,1271,16230,1368,6886,1041
1600000US0624680,0624680,"Fontana city, California",44612,1808,31525,1658,13087,1569
1600000US0626000,0626000,"Fremont city, California",66108,2297,42636,2425,23472,2183
1600000US0627000,0627000,"Fresno city, California",152559,3200,74047,3013,78512,3476
1600000US0628000,0628000,"Fullerton city, California",43526,1847,24053,1928,19473,1612
1600000US0629000,0629000,"Garden Grove city, California",42523,2091,22989,1880,19534,1539
1600000US0630000,0630000,"Glendale city, California",74173,2643,28551,2280,45622,3202
1600000US0632548,0632548,"Hawthorne city, California",27414,1850,7836,1257,19578,2047
1600000US0633000,0633000,"Hayward city, California",42656,2220,21784,1833,20872,1888
1600000US0633182,0633182,"Hemet city, California",27473,1916,16269,1870,11204,1686
1600000US0633434,0633434,"Hesperia city, California",24098,1502,17508,1637,6590,1061
1600000US0636000,0636000,"Huntington Beach city, California",74989,2471,47254,2674,27735,2106
1600000US0636448,0636448,"Indio city, California",24898,1354,13343,1650,11555,1237
1600000US0636546,0636546,"Inglewood city, California",38811,2762,13117,1153,25694,2657
1600000US0636770,0636770,"Irvine city, California",77343,2615,40814,2180,36529,2338
1600000US0639496,0639496,"Lake Forest city, California",25889,1321,17957,1492,7932,1229
1600000US0639892,0639892,"Lakewood city, California",25987,1773,17603,1611,8384,1171
1600000US0640130,0640130,"Lancaster city, California",44632,2054,29011,2292,15621,1773
1600000US0641992,0641992,"Livermore city, California",27463,1582,20518,1603,6945,1367
1600000US0643000,0643000,"Long Beach city, California",160736,4372,67167,3590,93569,3648
1600000US0644000,0644000,"Los Angeles city, California",1298409,10676,505443,8813,792966,11684
1600000US0644574,0644574,"Lynwood city, California",15558,1511,6295,965,9263,1347
1600000US0645484,0645484,"Manteca city, California",22203,1416,14347,1625,7856,1327
1600000US0646898,0646898,"Merced city, California",25344,1482,9866,1185,15478,1394
1600000US0647766,0647766,"Milpitas city, California",18688,1493,13021,1655,5667,1011
1600000US0648256,0648256,"Mission Viejo city, California",31440,1783,25713,1782,5727,1081
1600000US0648354,0648354,"Modesto city, California",67813,2402,39128,2359,28685,2417
1600000US0649270,0649270,"Moreno Valley city, California",50666,2475,32966,2201,17700,1827
1600000US0649670,0649670,"Mountain View city, California",31087,1641,13631,1463,17456,1349
1600000US0650076,0650076,"Murrieta city, California",29512,1828,21238,1779,8274,1331
1600000US0650258,0650258,"Napa city, California",29125,1337,17316,1660,11809,1467
1600000US0651182,0651182,"Newport Beach city, California",35219,1520,19289,1433,15930,1555
1600000US0652526,0652526,"Norwalk city, California",24830,1630,16713,1470,8117,1280
1600000US0653000,0653000,"Oakland city, California",156653,4405,64688,3094,91965,3916
1600000US0653322,0653322,"Oceanside city, California",62436,2382,37554,2205,24882,2065
1600000US0653896,0653896,"Ontario city, California",46318,2071,28289,2313,18029,2004
1600000US0653980,0653980,"Orange city, California",42121,1986,25614,1956,16507,1751
1600000US0654652,0654652,"Oxnard city, California",51191,2154,28154,1996,23037,1884
1600000US0655156,0655156,"Palmdale city, California",38698,1534,25890,1660,12808,1247
1600000US0656000,0656000,"Pasadena city, California",57332,3157,27091,2179,30241,2214
1600000US0657456,0657456,"Pittsburg city, California",21320,1605,11920,1469,9400,1328
1600000US0657792,0657792,"Pleasanton city, California",22497,1466,14574,1244,7923,1145
1600000US0658072,0658072,"Pomona city, California",38107,2024,21064,1964,17043,1700
1600000US0659451,0659451,"Rancho Cucamonga city, California",54612,2020,35972,2233,18640,2075
1600000US0659920,0659920,"Redding city, California",34759,1721,20242,1652,14517,1408
1600000US0659962,0659962,"Redlands city, California",24772,1834,14984,1796,9788,1573
1600000US0660018,0660018,"Redondo Beach city, California",27670,1486,15578,1532,12092,1352
1600000US0660102,0660102,"Redwood City city, California",26798,1541,14243,1348,12555,1207
1600000US0660466,0660466,"Rialto city, California",24598,1765,15961,1627,8637,1348
1600000US0660620,0660620,"Richmond city, California",34521,2304,17221,1822,17300,1921
1600000US0662000,0662000,"Riverside city, California",88938,3502,51752,2974,37186,2565
1600000US0662938,0662938,"Roseville city, California",41262,1792,26110,1798,15152,1814
1600000US0664000,0664000,"Sacramento city, California",177201,4384,85031,3742,92170,4013
1600000US0664224,0664224,"Salinas city, California",41418,1613,17936,1965,23482,1760
1600000US0665000,0665000,"San Bernardino city, California",56657,2284,28629,2353,28028,2366
1600000US0665042,0665042,"San Buenaventura (Ventura) city, California",38839,1764,20523,1671,18316,1655
1600000US0666000,0666000,"San Diego city, California",477217,5309,234580,5644,242637,5633
1600000US0667000,0667000,"San Francisco city, California",324588,3785,122182,4247,202406,4190
1600000US0668000,0668000,"San Jose city, California",297169,4605,176368,4821,120801,4222
1600000US0668084,0668084,"San Leandro city, California",25522,1856,14449,1277,11073,1420
1600000US0668196,0668196,"San Marcos city, California",25349,1136,15814,1364,9535,1033
1600000US0668252,0668252,"San Mateo city, California",37116,2157,20743,1814,16373,1830
1600000US0669000,0669000,"Santa Ana city, California",72503,3218,34174,2590,38329,2606
1600000US0669070,0669070,"Santa Barbara city, California",37646,1828,15488,1624,22158,1720
1600000US0669084,0669084,"Santa Clara city, California",40005,2265,16840,1705,23165,2036
1600000US0669088,0669088,"Santa Clarita city, California",53667,2090,38120,2276,15547,1685
1600000US0669196,0669196,"Santa Maria city, California",23672,1420,11534,1278,12138,1223
1600000US0670000,0670000,"Santa Monica city, California",44145,2631,12468,1321,31677,2519
1600000US0670098,0670098,"Santa Rosa city, California",59301,2395,30992,2156,28309,2432
1600000US0672016,0672016,"Simi Valley city, California",40249,1660,29102,2083,11147,1570
1600000US0673080,0673080,"South Gate city, California",24057,1410,10553,1336,13504,1412
1600000US0675000,0675000,"Stockton city, California",88830,3988,46951,3254,41879,3064
1600000US0677000,0677000,"Sunnyvale city, California",49162,1742,24373,1775,24789,1955
1600000US0678120,0678120,"Temecula city, California",29813,1813,19619,1699,10194,1396
1600000US0678582,0678582,"Thousand Oaks city, California",43034,1469,31866,1711,11168,1492
1600000US0680000,0680000,"Torrance city, California",53268,1995,30417,1911,22851,1854
1600000US0680238,0680238,"Tracy city, California",21963,1368,14536,1602,7427,1330
1600000US0680812,0680812,"Turlock city, California",22230,1250,11340,1373,10890,1434
1600000US0680854,0680854,"Tustin city, California",24235,1313,12819,1470,11416,1333
1600000US0681204,0681204,"Union City city, California",21613,1467,16028,1665,5585,1112
1600000US0681344,0681344,"Upland city, California",25063,1706,13380,1391,11683,1560
1600000US0681554,0681554,"Vacaville city, California",31169,1436,20627,1465,10542,1559
1600000US0681666,0681666,"Vallejo city, California",40546,1682,26702,1853,13844,1647
1600000US0682590,0682590,"Victorville city, California",32808,1640,20497,1994,12311,1580
1600000US0682954,0682954,"Visalia city, California",40910,1926,24172,2233,16738,1931
1600000US0682996,0682996,"Vista city, California",28397,1689,14667,1515,13730,1824
1600000US0684200,0684200,"West Covina city, California",30164,1744,19310,1823,10854,1628
1600000US0684550,0684550,"Westminster city, California",25428,1078,14158,1112,11270,1294
1600000US0685292,0685292,"Whittier city, California",25879,1472,14073,1488,11806,1346
1600000US0686832,0686832,"Yorba Linda city, California",22503,1297,18612,1428,3891,1088
1600000US0803455,0803455,"Arvada city, Colorado",42125,1642,29380,1982,12745,1419
1600000US0804000,0804000,"Aurora city, Colorado",117228,3367,70335,3312,46893,3101
1600000US0807850,0807850,"Boulder city, Colorado",39158,2271,19098,1581,20060,1889
1600000US0812815,0812815,"Centennial city, Colorado",37267,1404,31812,1652,5455,1068
1600000US0816000,0816000,"Colorado Springs city, Colorado",157343,2811,97079,3175,60264,2875
1600000US0820000,0820000,"Denver city, Colorado",251515,3803,131849,4124,119666,4423
1600000US0827425,0827425,"Fort Collins city, Colorado",53998,3108,28862,2197,25136,2333
1600000US0832155,0832155,"Greeley city, Colorado",31894,2115,18651,1787,13243,1664
1600000US0836410,0836410,"Highlands Ranch CDP, Colorado",32493,1453,27001,1598,5492,1263
1600000US0843000,0843000,"Lakewood city, Colorado",62269,2139,35854,1954,26415,1995
1600000US0845970,0845970,"Longmont city, Colorado",33878,1436,21571,1769,12307,1386
1600000US0846465,0846465,"Loveland city, Colorado",26146,1392,18073,1405,8073,1201
1600000US0862000,0862000,"Pueblo city, Colorado",41628,2304,25640,1978,15988,1516
1600000US0877290,0877290,"Thornton city, Colorado",40930,1779,29094,1890,11836,1448
1600000US0883835,0883835,"Westminster city, Colorado",40831,1807,27544,2169,13287,1573
1600000US0908000,0908000,"Bridgeport city, Connecticut",49915,1928,22248,2093,27667,2042
1600000US0918430,0918430,"Danbury city, Connecticut",29776,1602,19704,1539,10072,1452
1600000US0937000,0937000,"Hartford city, Connecticut",44186,2281,11535,1386,32651,2144
1600000US0950370,0950370,"New Britain city, Connecticut",27962,1650,12803,1565,15159,1561
1600000US0952000,0952000,"New Haven city, Connecticut",45309,2455,14632,1681,30677,2508
1600000US0955990,0955990,"Norwalk city, Connecticut",36603,1808,23382,1820,13221,1647
1600000US0973000,0973000,"Stamford city, Connecticut",45049,1996,24830,2175,20219,1785
1600000US0980000,0980000,"Waterbury city, Connecticut",41490,1962,18483,1782,23007,2152
1600000US1077580,1077580,"Wilmington city, Delaware",28678,1876,13589,1604,15089,1635
1600000US1150000,1150000,"Washington city, District of Columbia",249280,3172,111618,3411,137662,3905
1600000US1207300,1207300,"Boca Raton city, Florida",35039,1937,26605,2051,8434,1401
1600000US1207875,1207875,"Boynton Beach city, Florida",29105,2331,19141,1838,9964,1407
1600000US1208150,1208150,"Brandon CDP, Florida",33936,2498,19565,1518,14371,1864
1600000US1210275,1210275,"Cape Coral city, Florida",58101,2621,43534,2870,14567,1781
1600000US1212875,1212875,"Clearwater city, Florida",43783,5915,26639,3753,17144,2939
1600000US1214400,1214400,"Coral Springs city, Florida",41336,2177,28719,2010,12617,1814
1600000US1216475,1216475,"Davie town, Florida",31611,1481,22703,1359,8908,1540
1600000US1216725,1216725,"Deerfield Beach city, Florida",32090,2200,21528,2082,10562,1663
1600000US1217200,1217200,"Deltona city, Florida",27656,1547,22167,1823,5489,1326
1600000US1224000,1224000,"Fort Lauderdale city, Florida",74984,3257,43806,3038,31178,2839
1600000US1224125,1224125,"Fort Myers city, Florida",24757,1875,10866,1468,13891,1419
1600000US1225175,1225175,"Gainesville city, Florida",44912,2498,17646,1545,27266,2171
1600000US1230000,1230000,"Hialeah city, Florida",70237,3154,37552,2842,32685,3112
1600000US1232000,1232000,"Hollywood city, Florida",53003,5722,34197,3752,18806,2837
1600000US1235000,1235000,"Jacksonville city, Florida",312268,5445,193338,4303,118930,4934
1600000US1236100,1236100,"Kendall CDP, Florida",27518,1964,18102,1899,9416,1599
1600000US1238250,1238250,"Lakeland city, Florida",41650,2215,22631,1702,19019,2198
1600000US1239425,1239425,"Largo city, Florida",34824,1965,20652,1805,14172,1261
1600000US1239550,1239550,"Lauderhill city, Florida",25621,1987,16927,1764,8694,1584
1600000US1239925,1239925,"Lehigh Acres CDP, Florida",23876,1871,16334,1650,7542,1496
1600000US1243975,1243975,"Melbourne city, Florida",34796,2203,20494,1692,14302,1980
1600000US1245000,1245000,"Miami city, Florida",159609,5562,56054,3698,103555,4780
1600000US1245025,1245025,"Miami Beach city, Florida",41414,2497,17117,1852,24297,2185
1600000US1245060,1245060,"Miami Gardens city, Florida",31366,1924,21616,1955,9750,1567
1600000US1245975,1245975,"Miramar city, Florida",31006,1577,23076,1539,7930,1266
1600000US1253000,1253000,"Orlando city, Florida",98146,3166,42272,2644,55874,3072
1600000US1254000,1254000,"Palm Bay city, Florida",37702,1864,26750,1964,10952,1528
1600000US1254200,1254200,"Palm Coast city, Florida",27751,2045,20797,1710,6954,1529
1600000US1255775,1255775,"Pembroke Pines city, Florida",49602,2394,36507,2489,13095,1790
1600000US1257425,1257425,"Plantation city, Florida",33374,1826,23978,1761,9396,1471
1600000US1258050,1258050,"Pompano Beach city, Florida",42266,2382,26209,2287,16057,2207
1600000US1258715,1258715,"Port St. Lucie city, Florida",53906,2500,41802,2538,12104,1701
1600000US1263000,1263000,"St. Petersburg city, Florida",108116,3410,68006,3107,40110,2589
1600000US1268350,1268350,"Spring Hill CDP, Florida",35461,1884,28107,1857,7354,1159
1600000US1269700,1269700,"Sunrise city, Florida",32088,1907,23979,1937,8109,1547
1600000US1270600,1270600,"Tallahassee city, Florida",74065,3046,28872,2349,45193,2907
1600000US1271000,1271000,"Tampa city, Florida",140667,3931,75130,3141,65537,3664
1600000US1272145,1272145,"Town 'n' Country CDP, Florida",28697,2318,16834,1498,11863,2196
1600000US1276582,1276582,"Weston city, Florida",19498,914,14399,1300,5099,1106
1600000US1276600,1276600,"West Palm Beach city, Florida",42510,2419,24285,2149,18225,1759
1600000US1301052,1301052,"Albany city, Georgia",28123,1548,12220,1223,15903,1636
1600000US1303440,1303440,"Athens-Clarke County unified government (balance), Georgia",39436,1821,17523,1284,21913,1945
1600000US1304000,1304000,"Atlanta city, Georgia",206947,5183,108374,4908,98573,4772
1600000US1304204,1304204,"Augusta-Richmond County consolidated government (balance), Georgia",73052,3120,39803,2120,33249,2632
1600000US1319000,1319000,"Columbus city, Georgia",74569,3386,39908,2868,34661,2396
1600000US1349000,1349000,"Macon city, Georgia",35456,1825,15810,1512,19646,1822
1600000US1349756,1349756,"Marietta city, Georgia",26679,2072,11657,1680,15022,1773
1600000US1367284,1367284,"Roswell city, Georgia",29460,1867,21819,1804,7641,1191
1600000US1368516,1368516,"Sandy Springs city, Georgia",32985,1906,18113,1780,14872,1609
1600000US1369000,1369000,"Savannah city, Georgia",52637,2198,25006,2211,27631,1932
1600000US1517000,1517000,"Honolulu CDP, Hawaii",144700,3450,68573,3252,76127,3590
1600000US1608830,1608830,"Boise City city, Idaho",84056,2259,53332,2389,30724,2562
1600000US1652120,1652120,"Meridian city, Idaho",22136,924,17279,1214,4857,962
1600000US1656260,1656260,"Nampa city, Idaho",26672,1710,17150,1653,9522,1339
1600000US1702154,1702154,"Arlington Heights village, Illinois",27210,1442,21086,1405,6124,1059
1600000US1703012,1703012,"Aurora city, Illinois",57925,2125,40544,2246,17381,1976
1600000US1706613,1706613,"Bloomington city, Illinois",30284,1401,19717,1397,10567,1454
1600000US1707133,1707133,"Bolingbrook village, Illinois",18967,1360,15766,1396,3201,696
1600000US1712385,1712385,"Champaign city, Illinois",31087,2292,14049,1511,17038,2044
1600000US1714000,1714000,"Chicago city, Illinois",1072886,9605,502615,8907,570271,9638
1600000US1714351,1714351,"Cicero town, Illinois",19567,1124,10800,1195,8767,1449
1600000US1718823,1718823,"Decatur city, Illinois",31690,1665,19823,1497,11867,1549
1600000US1723074,1723074,"Elgin city, Illinois",33513,1790,23822,1681,9691,1479
1600000US1724582,1724582,"Evanston city, Illinois",29070,2177,17028,1678,12042,1494
1600000US1738570,1738570,"Joliet city, Illinois",46020,2008,34407,1994,11613,1508
1600000US1751622,1751622,"Naperville city, Illinois",48713,1808,38496,1817,10217,1456
1600000US1757225,1757225,"Palatine village, Illinois",24564,1171,17489,1321,7075,1063
1600000US1759000,1759000,"Peoria city, Illinois",50234,1877,30865,1928,19369,1360
1600000US1765000,1765000,"Rockford city, Illinois",61382,2412,34777,2168,26605,2398
1600000US1768003,1768003,"Schaumburg village, Illinois",29258,1610,22069,1489,7189,1282
1600000US1770122,1770122,"Skokie village, Illinois",25133,1384,18398,1650,6735,1249
1600000US1772000,1772000,"Springfield city, Illinois",51165,1851,33049,1814,18116,1977
1600000US1779293,1779293,"Waukegan city, Illinois",28360,1727,15830,1424,12530,1545
1600000US1805860,1805860,"Bloomington city, Indiana",29557,2101,8473,1057,21084,2006
1600000US1810342,1810342,"Carmel city, Indiana",27342,1341,20456,1334,6886,1127
1600000US1822000,1822000,"Evansville city, Indiana",50175,1624,26296,1678,23879,1799
1600000US1823278,1823278,"Fishers town, Indiana",27181,1513,20030,1626,7151,1479
1600000US1825000,1825000,"Fort Wayne city, Indiana",99260,2597,62979,2390,36281,2217
1600000US1827000,1827000,"Gary city, Indiana",37572,2019,20275,1844,17297,1698
1600000US1831000,1831000,"Hammond city, Indiana",28138,1684,18623,1523,9515,1426
1600000US1836003,1836003,"Indianapolis city (balance), Indiana",323071,5005,181621,4057,141450,5273
1600000US1840788,1840788,"Lafayette city, Indiana",27471,1575,13106,1207,14365,1460
1600000US1851876,1851876,"Muncie city, Indiana",28065,2928,13953,1648,14112,2218
1600000US1871000,1871000,"South Bend city, Indiana",40523,1783,24215,1892,16308,1630
1600000US1912000,1912000,"Cedar Rapids city, Iowa",53167,1748,37051,1935,16116,1807
1600000US1919000,1919000,"Davenport city, Iowa",41167,1953,26280,1952,14887,1596
1600000US1921000,1921000,"Des Moines city, Iowa",86454,2513,52569,2703,33885,2891
1600000US1938595,1938595,"Iowa City city, Iowa",27241,1596,13242,1022,13999,1493
1600000US1973335,1973335,"Sioux City city, Iowa",31919,1174,19389,1474,12530,1561
1600000US1982425,1982425,"Waterloo city, Iowa",28292,1647,18111,1716,10181,1237
1600000US2036000,2036000,"Kansas City city, Kansas",53019,1658,31955,1912,21064,1887
1600000US2038900,2038900,"Lawrence city, Kansas",34605,1518,16321,1302,18284,1547
1600000US2052575,2052575,"Olathe city, Kansas",42907,1531,31545,1727,11362,1550
1600000US2053775,2053775,"Overland Park city, Kansas",70022,2172,44592,2093,25430,2136
1600000US2071000,2071000,"Topeka city, Kansas",54552,1571,31496,1877,23056,1681
1600000US2079000,2079000,"Wichita city, Kansas",150353,3058,93387,3286,56966,3120
1600000US2146027,2146027,"Lexington-Fayette urban county, Kentucky",121475,2601,67565,2601,53910,3128
1600000US2148006,2148006,"Louisville/Jefferson County metro government (balance), Kentucky",234123,4167,144673,4456,89450,4380
1600000US2205000,2205000,"Baton Rouge city, Louisiana",88041,2730,42886,2240,45155,2788
1600000US2239475,2239475,"Kenner city, Louisiana",22321,1546,14175,1336,8146,1215
1600000US2240735,2240735,"Lafayette city, Louisiana",45465,2524,26353,2126,19112,2264
1600000US2241155,2241155,"Lake Charles city, Louisiana",29627,1747,17368,1585,12259,1893
1600000US2250115,2250115,"Metairie CDP, Louisiana",58666,2087,37273,1742,21393,2089
1600000US2255000,2255000,"New Orleans city, Louisiana",128267,3734,65572,2674,62695,3391
1600000US2270000,2270000,"Shreveport city, Louisiana",78625,2597,44105,2462,34520,2665
1600000US2404000,2404000,"Baltimore city, Maryland",234840,3788,119097,4296,115743,4657
1600000US2419125,2419125,"Columbia CDP, Maryland",34466,1535,23524,1502,10942,1519
1600000US2426000,2426000,"Ellicott City CDP, Maryland",23365,1453,17075,1090,6290,1107
1600000US2472450,2472450,"Silver Spring CDP, Maryland",29407,1749,14624,1218,14783,1717
1600000US2483837,2483837,"Wheaton-Glenmont CDP, Maryland",20139,1668,13430,1227,6709,1283
1600000US2507000,2507000,"Boston city, Massachusetts",240155,5203,89308,3674,150847,5262
1600000US2509000,2509000,"Brockton city, Massachusetts",29797,1767,17453,1709,12344,1610
1600000US2511000,2511000,"Cambridge city, Massachusetts",48194,2354,16533,1845,31661,2282
1600000US2523000,2523000,"Fall River city, Massachusetts",37365,2364,15383,1463,21982,2211
1600000US2524960,2524960,"Framingham CDP, Massachusetts",24751,1826,13626,1227,11125,1509
1600000US2534550,2534550,"Lawrence city, Massachusetts",23764,1441,7720,1316,16044,1367
1600000US2537000,2537000,"Lowell city, Massachusetts",38127,2127,19740,1770,18387,1860
1600000US2537490,2537490,"Lynn city, Massachusetts",30557,1983,14479,1176,16078,1782
1600000US2545000,2545000,"New Bedford city, Massachusetts",37329,2067,16272,1587,21057,1792
1600000US2545560,2545560,"Newton city, Massachusetts",29727,1630,20164,1474,9563,1366
1600000US2555745,2555745,"Quincy city, Massachusetts",39704,2030,19411,1677,20293,1955
1600000US2562535,2562535,"Somerville city, Massachusetts",28984,1883,9280,1542,19704,1646
1600000US2567000,2567000,"Springfield city, Massachusetts",56904,2499,29235,2036,27669,2341
1600000US2582000,2582000,"Worcester city, Massachusetts",68728,4333,31576,2553,37152,3015
1600000US2603000,2603000,"Ann Arbor city, Michigan",41861,3457,18640,1804,23221,2671
1600000US2613110,2613110,"Canton CDP, Michigan",27630,1220,21847,1183,5783,1014
1600000US2616510,2616510,"Clinton CDP, Michigan",39439,2182,27072,1831,12367,1763
1600000US2621000,2621000,"Dearborn city, Michigan",28645,1594,21155,1561,7490,1253
1600000US2622000,2622000,"Detroit city, Michigan",317357,5112,170584,5598,146773,5508
1600000US2627440,2627440,"Farmington Hills city, Michigan",31638,1532,21531,1317,10107,1263
1600000US2629000,2629000,"Flint city, Michigan",46629,2262,26928,2338,19701,2184
1600000US2634000,2634000,"Grand Rapids city, Michigan",72593,2338,42469,2457,30124,2384
1600000US2642160,2642160,"Kalamazoo city, Michigan",28304,1797,12863,1475,15441,1417
1600000US2646000,2646000,"Lansing city, Michigan",48362,2004,26947,1724,21415,1813
1600000US2649000,2649000,"Livonia city, Michigan",32023,1492,28070,1381,3953,934
1600000US2665440,2665440,"Pontiac city, Michigan",26316,1750,15097,1711,11219,1404
1600000US2669035,2669035,"Rochester Hills city, Michigan",27431,1403,20635,1217,6796,955
1600000US2672818,2672818,"Shelby CDP, Michigan",26981,1564,21175,1464,5806,1105
1600000US2674900,2674900,"Southfield city, Michigan",31752,1717,16352,1364,15400,1548
1600000US2676460,2676460,"Sterling Heights city, Michigan",48092,1822,36448,1724,11644,1471
1600000US2680700,2680700,"Troy city, Michigan",30272,1152,23618,1239,6654,1045
1600000US2684000,2684000,"Warren city, Michigan",53635,1949,39875,2051,13760,1538
1600000US2684220,2684220,"Waterford CDP, Michigan",28504,1428,21038,1625,7466,1250
1600000US2685510,2685510,"West Bloomfield Township CDP, Michigan",22985,1102,18981,1010,4004,847
1600000US2686000,2686000,"Westland city, Michigan",30316,3196,20313,2278,10003,1737
1600000US2688940,2688940,"Wyoming city, Michigan",25648,1340,17810,1330,7838,1166
1600000US2706616,2706616,"Bloomington city, Minnesota",36042,2230,25689,2080,10353,1363
1600000US2707966,2707966,"Brooklyn Park city, Minnesota",24490,1691,18286,1480,6204,1016
1600000US2717000,2717000,"Duluth city, Minnesota",35930,1620,19065,1268,16865,1527
1600000US2743000,2743000,"Minneapolis city, Minnesota",163048,3714,82847,2950,80201,3614
1600000US2751730,2751730,"Plymouth city, Minnesota",30126,1458,22025,1276,8101,1161
1600000US2754880,2754880,"Rochester city, Minnesota",41058,1417,30362,1338,10696,1275
1600000US2756896,2756896,"St. Cloud city, Minnesota",23471,1925,11705,1260,11766,1711
1600000US2758000,2758000,"St. Paul city, Minnesota",110354,2643,58319,2487,52035,2766
1600000US2829700,2829700,"Gulfport city, Mississippi",26653,1832,15808,1795,10845,1820
1600000US2836000,2836000,"Jackson city, Mississippi",63651,2431,31014,2265,32637,2502
1600000US2915670,2915670,"Columbia city, Missouri",43561,1691,22300,1606,21261,2096
1600000US2935000,2935000,"Independence city, Missouri",44715,2032,30131,2067,14584,1686
1600000US2938000,2938000,"Kansas City city, Missouri",198229,3672,116078,3441,82151,3819
1600000US2941348,2941348,"Lee's Summit city, Missouri",31870,1359,24851,1336,7019,1232
1600000US2954074,2954074,"O'Fallon city, Missouri",28344,1380,23130,1434,5214,1190
1600000US2964082,2964082,"St. Charles city, Missouri",25987,2419,17428,2147,8559,1277
1600000US2964550,2964550,"St. Joseph city, Missouri",28231,1442,18517,1524,9714,1416
1600000US2965000,2965000,"St. Louis city, Missouri",146463,4157,68242,3778,78221,3974
1600000US2970000,2970000,"Springfield city, Missouri",70506,2396,33757,2279,36749,2515
1600000US3006550,3006550,"Billings city, Montana",42752,1444,28025,1567,14727,1536
1600000US3050200,3050200,"Missoula city, Montana",28177,2320,13234,1439,14943,2121
1600000US3128000,3128000,"Lincoln city, Nebraska",101044,2307,58106,2431,42938,2699
1600000US3137000,3137000,"Omaha city, Nebraska",176574,3319,107691,2961,68883,3287
1600000US3223770,3223770,"Enterprise CDP, Nevada",37403,2354,23374,2298,14029,2314
1600000US3231900,3231900,"Henderson city, Nevada",101518,2932,68114,2774,33404,2531
1600000US3240000,3240000,"Las Vegas city, Nevada",203892,4650,112226,3679,91666,4168
1600000US3251800,3251800,"North Las Vegas city, Nevada",69380,2634,43565,2831,25815,2340
1600000US3254600,3254600,"Paradise CDP, Nevada",80048,3827,36357,2377,43691,3085
1600000US3260600,3260600,"Reno city, Nevada",86029,2869,44066,2491,41963,2697
1600000US3268400,3268400,"Sparks city, Nevada",32879,1609,18864,1651,14015,1642
1600000US3268585,3268585,"Spring Valley CDP, Nevada",67143,3197,33610,2586,33533,2798
1600000US3271400,3271400,"Sunrise Manor CDP, Nevada",61169,2722,33597,2405,27572,2534
1600000US3345140,3345140,"Manchester city, New Hampshire",42949,1894,22138,1762,20811,1681
1600000US3350260,3350260,"Nashua city, New Hampshire",35527,1800,20892,1747,14635,1690
1600000US3410000,3410000,"Camden city, New Jersey",27284,1693,12013,1592,15271,1463
1600000US3413690,3413690,"Clifton city, New Jersey",28382,1751,17556,1627,10826,1324
1600000US3419390,3419390,"East Orange city, New Jersey",25206,1673,6413,1034,18793,1705
1600000US3420260,3420260,"Edison CDP, New Jersey",33715,1750,22725,1571,10990,1498
1600000US3421000,3421000,"Elizabeth city, New Jersey",40819,1703,10909,1351,29910,1789
1600000US3436000,3436000,"Jersey City city, New Jersey",96863,2651,30307,2350,66556,2965
1600000US3451000,3451000,"Newark city, New Jersey",93220,2917,23290,1959,69930,2914
1600000US3456550,3456550,"Passaic city, New Jersey",19171,1592,5524,835,13647,1637
1600000US3457000,3457000,"Paterson city, New Jersey",42977,2068,12782,1814,30195,2146
1600000US3473110,3473110,"Toms River CDP, New Jersey",33942,1720,28648,1707,5294,1086
1600000US3474000,3474000,"Trenton city, New Jersey",25638,2338,10206,1572,15432,1857
1600000US3474630,3474630,"Union City city, New Jersey",21583,1786,3934,914,17649,1625
1600000US3502000,3502000,"Albuquerque city, New Mexico",217353,2928,130154,3386,87199,3936
1600000US3539380,3539380,"Las Cruces city, New Mexico",35603,2223,20883,1795,14720,1542
1600000US3563460,3563460,"Rio Rancho city, New Mexico",29594,1071,22341,1225,7253,1208
1600000US3570500,3570500,"Santa Fe city, New Mexico",29547,1619,17696,1535,11851,1531
1600000US3601000,3601000,"Albany city, New York",40605,2406,16690,1752,23915,2070
1600000US3611000,3611000,"Buffalo city, New York",117333,3184,52100,2996,65233,3224
1600000US3615000,3615000,"Cheektowaga CDP, New York",33518,1653,24179,1524,9339,1497
1600000US3649121,3649121,"Mount Vernon city, New York",25547,1618,9436,1329,16111,1426
1600000US3650617,3650617,"New Rochelle city, New York",26578,1827,12708,1560,13870,1614
1600000US3651000,3651000,"New York city, New York",3087496,11174,1036554,13574,2050942,15866
1600000US3663000,3663000,"Rochester city, New York",86163,2788,36485,2370,49678,2827
1600000US3673000,3673000,"Syracuse city, New York",56110,2535,23744,1673,32366,2174
1600000US3684000,3684000,"Yonkers city, New York",70402,2553,32130,2467,38272,2060
1600000US3702140,3702140,"Asheville city, North Carolina",36640,2628,20207,1892,16433,1783
1600000US3710740,3710740,"Cary town, North Carolina",49608,2090,36087,2172,13521,1519
1600000US3712000,3712000,"Charlotte city, North Carolina",294421,4338,168419,4608,126002,4613
1600000US3714100,3714100,"Concord city, North Carolina",24948,1353,16572,1335,8376,1299
1600000US3719000,3719000,"Durham city, North Carolina",93673,3722,49771,2567,43902,3163
1600000US3722920,3722920,"Fayetteville city, North Carolina",72673,3587,35901,2285,36772,3313
1600000US3725580,3725580,"Gastonia city, North Carolina",28349,1231,17199,1592,11150,1339
1600000US3728000,3728000,"Greensboro city, North Carolina",105082,2465,56893,2898,48189,2840
1600000US3728080,3728080,"Greenville city, North Carolina",36824,1764,15120,1623,21704,1845
1600000US3731400,3731400,"High Point city, North Carolina",37705,4431,24130,3065,13575,2342
1600000US3734200,3734200,"Jacksonville city, North Carolina",22295,2855,7745,1451,14550,2207
1600000US3755000,3755000,"Raleigh city, North Carolina",153176,3765,83996,3078,69180,3866
1600000US3774440,3774440,"Wilmington city, North Carolina",46974,2350,22421,1766,24553,2484
1600000US3775000,3775000,"Winston-Salem city, North Carolina",88600,2771,51473,2276,37127,2848
1600000US3825700,3825700,"Fargo city, North Dakota",43853,1259,19915,1473,23938,1491
1600000US3901000,3901000,"Akron city, Ohio",88739,2714,48294,2514,40445,2488
1600000US3912000,3912000,"Canton city, Ohio",31762,1660,18280,1656,13482,1477
1600000US3915000,3915000,"Cincinnati city, Ohio",138857,4968,55270,2708,83587,4556
1600000US3916000,3916000,"Cleveland city, Ohio",185241,4737,85419,3758,99822,4231
1600000US3918000,3918000,"Columbus city, Ohio",314169,5168,154321,4909,159848,4931
1600000US3921000,3921000,"Dayton city, Ohio",63724,2427,28942,2107,34782,2316
1600000US3944856,3944856,"Lorain city, Ohio",27739,1677,14261,1454,13478,1434
1600000US3961000,3961000,"Parma city, Ohio",31120,1530,23016,1430,8104,1197
1600000US3977000,3977000,"Toledo city, Ohio",126997,3002,72363,3188,54634,3047
1600000US3988000,3988000,"Youngstown city, Ohio",32133,1631,19319,1467,12814,1733
1600000US4009050,4009050,"Broken Arrow city, Oklahoma",34660,1780,27851,1821,6809,1225
1600000US4023200,4023200,"Edmond city, Oklahoma",30713,1357,22143,1607,8570,1216
1600000US4041850,4041850,"Lawton city, Oklahoma",31261,1533,16109,1313,15152,1493
1600000US4052500,4052500,"Norman city, Oklahoma",41696,1981,24431,1734,17265,1814
1600000US4055000,4055000,"Oklahoma City city, Oklahoma",223557,4315,132213,3780,91344,3937
1600000US4075000,4075000,"Tulsa city, Oklahoma",164518,2812,88856,3094,75662,3171
1600000US4105350,4105350,"Beaverton city, Oregon",36034,1984,17967,1443,18067,1652
1600000US4105800,4105800,"Bend city, Oregon",31416,1772,18552,1542,12864,1938
1600000US4123850,4123850,"Eugene city, Oregon",63445,2454,32779,2150,30666,2140
1600000US4131250,4131250,"Gresham city, Oregon",35175,1835,18665,1553,16510,1775
1600000US4134100,4134100,"Hillsboro city, Oregon",32194,1755,17502,1703,14692,1692
1600000US4147000,4147000,"Medford city, Oregon",31216,1530,16488,1541,14728,1680
1600000US4159000,4159000,"Portland city, Oregon",238901,3634,128432,4007,110469,3953
1600000US4164900,4164900,"Salem city, Oregon",57667,1811,33880,2140,23787,1946
1600000US4202000,4202000,"Allentown city, Pennsylvania",39354,1710,21316,1697,18038,1560
1600000US4206088,4206088,"Bethlehem city, Pennsylvania",27915,1938,14675,1507,13240,1783
1600000US4224000,4224000,"Erie city, Pennsylvania",42702,1961,23695,1722,19007,1722
1600000US4260000,4260000,"Philadelphia city, Pennsylvania",569835,6725,311376,6950,258459,7971
1600000US4261000,4261000,"Pittsburgh city, Pennsylvania",137580,5941,64805,3404,72775,4350
1600000US4263624,4263624,"Reading city, Pennsylvania",27087,2061,11484,1449,15603,1795
1600000US4269000,4269000,"Scranton city, Pennsylvania",28661,2804,17026,1865,11635,1793
1600000US4419180,4419180,"Cranston city, Rhode Island",30671,1446,20186,1728,10485,1348
1600000US4454640,4454640,"Pawtucket city, Rhode Island",28582,1525,12999,1218,15583,1502
1600000US4459000,4459000,"Providence city, Rhode Island",56584,2534,21075,2170,35509,2412
1600000US4474300,4474300,"Warwick city, Rhode Island",35618,1459,27175,1617,8443,1351
1600000US4513330,4513330,"Charleston city, South Carolina",48858,2540,25914,2094,22944,2242
1600000US4516000,4516000,"Columbia city, South Carolina",48061,2117,23449,1872,24612,2292
1600000US4548535,4548535,"Mount Pleasant town, South Carolina",27563,1651,19874,1402,7689,1402
1600000US4550875,4550875,"North Charleston city, South Carolina",39322,2574,17809,1542,21513,2277
1600000US4561405,4561405,"Rock Hill city, South Carolina",25785,1759,14707,1531,11078,1537
1600000US4652980,4652980,"Rapid City city, South Dakota",26768,1319,15938,1333,10830,1547
1600000US4659020,4659020,"Sioux Falls city, South Dakota",62029,1821,39819,1738,22210,1829
1600000US4714000,4714000,"Chattanooga city, Tennessee",72335,2776,40293,2571,32042,2559
1600000US4715160,4715160,"Clarksville city, Tennessee",48550,2006,27338,2210,21212,2213
1600000US4740000,4740000,"Knoxville city, Tennessee",86597,2510,46982,2355,39615,2383
1600000US4748000,4748000,"Memphis city, Tennessee",254006,4635,134934,4791,119072,4968
1600000US4751560,4751560,"Murfreesboro city, Tennessee",41703,1698,23028,1678,18675,1672
1600000US4752006,4752006,"Nashville-Davidson metropolitan government (balance), Tennessee",243539,4110,137520,4363,106019,4407
1600000US4801000,4801000,"Abilene city, Texas",41160,1810,23829,1649,17331,2061
1600000US4801924,4801924,"Allen city, Texas",25480,1517,21082,1629,4398,973
1600000US4803000,4803000,"Amarillo city, Texas",71072,2137,44155,2131,26917,2034
1600000US4804000,4804000,"Arlington city, Texas",132762,3250,76966,2996,55796,3062
1600000US4805000,4805000,"Austin city, Texas",316857,4972,145174,5021,171683,5948
1600000US4806128,4806128,"Baytown city, Texas",24864,1339,16242,1178,8622,1103
1600000US4807000,4807000,"Beaumont city, Texas",44704,2170,23269,2208,21435,2104
1600000US4810768,4810768,"Brownsville city, Texas",48184,2057,28359,1899,19825,1740
1600000US4810912,4810912,"Bryan city, Texas",25535,1632,12633,1162,12902,1601
1600000US4813024,4813024,"Carrollton city, Texas",44332,2441,28525,2211,15807,1922
1600000US4815976,4815976,"College Station city, Texas",32434,2098,10851,1283,21583,2102
1600000US4817000,4817000,"Corpus Christi city, Texas",105068,3158,62281,2418,42787,2873
1600000US4819000,4819000,"Dallas city, Texas",483200,7538,218455,5675,264745,6692
1600000US4819972,4819972,"Denton city, Texas",35916,3400,18057,2280,17859,1913
1600000US4822660,4822660,"Edinburg city, Texas",22889,1338,13006,1356,9883,1731
1600000US4824000,4824000,"El Paso city, Texas",208895,2779,124279,3329,84616,4334
1600000US4826232,4826232,"Flower Mound town, Texas",21469,1311,19420,1348,2049,925
1600000US4827000,4827000,"Fort Worth city, Texas",255689,5265,153099,4695,102590,5080
1600000US4827684,4827684,"Frisco city, Texas",38791,2007,31073,2360,7718,1535
1600000US4829000,4829000,"Garland city, Texas",67638,2578,42457,2135,25181,2052
1600000US4830464,4830464,"Grand Prairie city, Texas",51060,1962,31954,2130,19106,1890
1600000US4832372,4832372,"Harlingen city, Texas",22824,1492,13279,1566,9545,1473
1600000US4835000,4835000,"Houston city, Texas",829052,8847,393222,7444,435830,9358
1600000US4837000,4837000,"Irving city, Texas",73979,3246,29044,2332,44935,2821
1600000US4839148,4839148,"Killeen city, Texas",42303,1291,19779,1739,22524,1783
1600000US4841464,4841464,"Laredo city, Texas",61877,1724,39803,2295,22074,2194
1600000US4841980,4841980,"League City city, Texas",26944,1355,21141,1362,5803,1232
1600000US4842508,4842508,"Lewisville city, Texas",36260,2568,16814,1808,19446,2343
1600000US4843888,4843888,"Longview city, Texas",29574,1585,17134,1402,12440,1523
1600000US4845000,4845000,"Lubbock city, Texas",90280,2859,49346,2332,40934,3012
1600000US4845384,4845384,"McAllen city, Texas",47932,2123,29821,2079,18111,2230
1600000US4845744,4845744,"McKinney city, Texas",40126,2384,30631,2184,9495,1476
1600000US4847892,4847892,"Mesquite city, Texas",43967,2121,28122,2216,15845,1723
1600000US4848072,4848072,"Midland city, Texas",39958,1531,26452,1724,13506,1391
1600000US4848768,4848768,"Mission city, Texas",19954,1381,15142,1712,4812,1022
1600000US4848804,4848804,"Missouri City city, Texas",20307,1523,17119,1573,3188,932
1600000US4852356,4852356,"North Richland Hills city, Texas",24317,1188,15144,1459,9173,1391
1600000US4853388,4853388,"Odessa city, Texas",38552,1204,23081,1425,15471,1563
1600000US4856000,4856000,"Pasadena city, Texas",47339,1877,26298,1758,21041,1990
1600000US4856348,4856348,"Pearland city, Texas",30582,1482,24583,1786,5999,1309
1600000US4857200,4857200,"Pharr city, Texas",19587,1455,13044,1370,6543,1188
1600000US4858016,4858016,"Plano city, Texas",95869,2846,64382,2618,31487,2572
1600000US4861796,4861796,"Richardson city, Texas",37512,1975,22486,1830,15026,1778
1600000US4863500,4863500,"Round Rock city, Texas",31950,1896,20661,1854,11289,1625
1600000US4864472,4864472,"San Angelo city, Texas",36636,1836,22783,1506,13853,1941
1600000US4865000,4865000,"San Antonio city, Texas",462283,5263,272645,5695,189638,5929
1600000US4870808,4870808,"Sugar Land city, Texas",25630,1313,20630,1746,5000,1259
1600000US4872656,4872656,"The Woodlands CDP, Texas",23413,1381,16600,1254,6813,1378
1600000US4874144,4874144,"Tyler city, Texas",33903,1872,19753,1476,14150,1703
1600000US4876000,4876000,"Waco city, Texas",44551,2142,20618,1836,23933,2158
1600000US4879000,4879000,"Wichita Falls city, Texas",38209,1558,21943,1679,16266,1709
1600000US4943660,4943660,"Layton city, Utah",21408,1045,15319,1126,6089,1064
1600000US4955980,4955980,"Ogden city, Utah",29852,1615,16413,1733,13439,1494
1600000US4957300,4957300,"Orem city, Utah",25355,1445,16187,1297,9168,1269
1600000US4962470,4962470,"Provo city, Utah",28364,1683,11202,1170,17162,1601
1600000US4965330,4965330,"St. George city, Utah",25572,1558,16362,1629,9210,1469
1600000US4967000,4967000,"Salt Lake City city, Utah",72509,2680,36582,2440,35927,2455
1600000US4967440,4967440,"Sandy city, Utah",30569,1701,24648,1774,5921,1094
1600000US4982950,4982950,"West Jordan city, Utah",30407,1509,24410,1543,5997,1116
1600000US4983470,4983470,"West Valley City city, Utah",37730,1537,26640,1617,11090,1253
1600000US5101000,5101000,"Alexandria city, Virginia",63734,1967,29170,2289,34564,2490
1600000US5103000,5103000,"Arlington CDP, Virginia",90561,2452,44856,2255,45705,2695
1600000US5116000,5116000,"Chesapeake city, Virginia",80504,1488,60533,2284,19971,2099
1600000US5121088,5121088,"Dale City CDP, Virginia",20276,1381,16048,1451,4228,1012
1600000US5135000,5135000,"Hampton city, Virginia",53307,1694,30263,2086,23044,2078
1600000US5147672,5147672,"Lynchburg city, Virginia",27088,1673,16774,1476,10314,1537
1600000US5156000,5156000,"Newport News city, Virginia",74397,4334,39044,2245,35353,4004
1600000US5157000,5157000,"Norfolk city, Virginia",85060,2377,38452,2003,46608,2594
1600000US5164000,5164000,"Portsmouth city, Virginia",39166,1237,22120,1677,17046,1605
1600000US5167000,5167000,"Richmond city, Virginia",80315,2446,36684,2224,43631,2691
1600000US5168000,5168000,"Roanoke city, Virginia",42233,1570,23124,1785,19109,1611
1600000US5176432,5176432,"Suffolk city, Virginia",29758,1045,22779,1378,6979,1105
1600000US5182000,5182000,"Virginia Beach city, Virginia",162830,2561,102668,3266,60162,2995
1600000US5305210,5305210,"Bellevue city, Washington",52561,2212,31597,2167,20964,2017
1600000US5305280,5305280,"Bellingham city, Washington",32917,1978,14604,1413,18313,1862
1600000US5322640,5322640,"Everett city, Washington",42294,2159,18851,1668,23443,2098
1600000US5323515,5323515,"Federal Way city, Washington",32181,1720,18590,1890,13591,1390
1600000US5335275,5335275,"Kennewick city, Washington",24127,1568,14867,1476,9260,1301
1600000US5335415,5335415,"Kent city, Washington",31152,1919,16831,1673,14321,1591
1600000US5363000,5363000,"Seattle city, Washington",287585,4425,143452,4226,144133,4483
1600000US5367000,5367000,"Spokane city, Washington",85496,2574,50616,2188,34880,2593
1600000US5367167,5367167,"Spokane Valley city, Washington",36060,1762,22474,1411,13586,1656
1600000US5370000,5370000,"Tacoma city, Washington",79544,3503,42240,3065,37304,2524
1600000US5374060,5374060,"Vancouver city, Washington",65956,1855,31059,1856,34897,1930
1600000US5380010,5380010,"Yakima city, Washington",31385,1704,16644,1319,14741,1681
1600000US5502375,5502375,"Appleton city, Wisconsin",26989,1461,19016,1243,7973,1071
1600000US5522300,5522300,"Eau Claire city, Wisconsin",26828,1340,14651,1047,12177,1176
1600000US5531000,5531000,"Green Bay city, Wisconsin",41072,1736,24261,1724,16811,1594
1600000US5539225,5539225,"Kenosha city, Wisconsin",36626,1815,22015,1547,14611,1797
1600000US5548000,5548000,"Madison city, Wisconsin",103338,2872,51363,2408,51975,2579
1600000US5553000,5553000,"Milwaukee city, Wisconsin",224827,4708,104330,3379,120497,3965
1600000US5566000,5566000,"Racine city, Wisconsin",31672,1602,17660,1518,14012,1686
1600000US5584250,5584250,"Waukesha city, Wisconsin",28792,1409,16387,1333,12405,1375
