GEO.id,GEO.id2,GEO.display-label,HD01_VD01,HD02_VD01,HD01_VD02,HD02_VD02,HD01_VD03,HD02_VD03
1600000US0107000,0107000,"Birmingham city, Alabama",87228,2521,44824,2658,42404,2905
1600000US0121184,0121184,"Dothan city, Alabama",25840,1012,15142,909,10698,693
1600000US0135896,0135896,"Hoover city, Alabama",30280,1881,20130,1541,10150,1453
1600000US0137000,0137000,"Huntsville city, Alabama",74841,2444,46809,2335,28032,2529
1600000US0150000,0150000,"Mobile city, Alabama",75328,2724,44130,2239,31198,2825
1600000US0151000,0151000,"Montgomery city, Alabama",80035,2462,45703,2017,34332,2358
1600000US0177256,0177256,"Tuscaloosa city, Alabama",31827,2242,16495,1501,15332,2136
1600000US0203000,0203000,"Anchorage municipality, Alaska",104993,2002,64018,2242,40975,2566
1600000US0404720,0404720,"Avondale city, Arizona",21262,1195,13890,1641,7372,1259
1600000US0412000,0412000,"Chandler city, Arizona",83996,3322,56095,3251,27901,3022
1600000US0423620,0423620,"Flagstaff city, Arizona",20985,2775,9266,1582,11719,1919
1600000US0427400,0427400,"Gilbert town, Arizona",68797,2155,49293,2560,19504,2306
1600000US0427820,0427820,"Glendale city, Arizona",76848,3153,42968,2798,33880,2535
1600000US0428380,0428380,"Goodyear city, Arizona",20850,1617,16014,1802,4836,1184
1600000US0446000,0446000,"Mesa city, Arizona",162691,4466,100527,4072,62164,3633
1600000US0454050,0454050,"Peoria city, Arizona",55293,2592,37974,2430,17319,2124
1600000US0455000,0455000,"Phoenix city, Arizona",511432,7172,285182,7086,226250,6816
1600000US0464210,0464210,"San Tan Valley CDP, Arizona",21225,2345,18165,2060,3060,1105
1600000US0465000,0465000,"Scottsdale city, Arizona",99086,3379,68865,2848,30221,3100
1600000US0471510,0471510,"Surprise city, Arizona",41747,2085,31806,2180,9941,1630
1600000US0473000,0473000,"Tempe city, Arizona",62611,3062,28538,2428,34073,2398
1600000US0477000,0477000,"Tucson city, Arizona",201761,4584,105875,4535,95886,4389
1600000US0485540,0485540,"Yuma city, Arizona",31417,1811,19893,1953,11524,1677
1600000US0523290,0523290,"Fayetteville city, Arkansas",29469,2395,12511,1846,16958,1857
1600000US0524550,0524550,"Fort Smith city, Arkansas",33742,1768,19735,1842,14007,1405
1600000US0535710,0535710,"Jonesboro city, Arkansas",25315,1200,14083,1142,11232,1470
1600000US0541000,0541000,"Little Rock city, Arkansas",77499,2546,44347,2107,33152,2495
1600000US0566080,0566080,"Springdale city, Arkansas",23226,1333,11854,1380,11372,1217
1600000US0600562,0600562,"Alameda city, California",28011,1368,13143,1413,14868,1515
1600000US0600884,0600884,"Alhambra city, California",28100,2034,10693,1375,17407,1691
1600000US0602000,0602000,"Anaheim city, California",100404,3112,48584,2753,51820,2637
1600000US0602252,0602252,"Antioch city, California",30970,2008,19439,2270,11531,1455
1600000US0602364,0602364,"Apple Valley town, California",23900,1442,16895,1408,7005,1169
1600000US0602553,0602553,"Arden-Arcade CDP, California",39936,2173,18480,1401,21456,1979
1600000US0603526,0603526,"Bakersfield city, California",109420,3039,64761,3103,44659,2648
1600000US0603666,0603666,"Baldwin Park city, California",17045,1462,10257,1204,6788,1313
1600000US0604982,0604982,"Bellflower city, California",25199,1505,10132,1385,15067,1700
1600000US0606000,0606000,"Berkeley city, California",44724,2597,17737,1678,26987,2226
1600000US0608786,0608786,"Buena Park city, California",23126,1410,12533,1208,10593,1318
1600000US0608954,0608954,"Burbank city, California",42231,1949,18455,1839,23776,1713
1600000US0610046,0610046,"Camarillo city, California",25340,1562,17709,1541,7631,1279
1600000US0611194,0611194,"Carlsbad city, California",40934,2295,26491,2032,14443,1604
1600000US0611530,0611530,"Carson city, California",24875,1671,17438,1665,7437,1248
1600000US0613014,0613014,"Chico city, California",34128,1671,15456,1245,18672,1702
1600000US0613210,0613210,"Chino city, California",20148,1278,14462,1443,5686,1319
1600000US0613214,0613214,"Chino Hills city, California",21151,1204,17977,1182,3174,679
1600000US0613392,0613392,"Chula Vista city, California",74991,2582,44572,2384,30419,2240
1600000US0613588,0613588,"Citrus Heights city, California",33165,1776,18342,1833,14823,1571
1600000US0614218,0614218,"Clovis city, California",32299,1649,19503,1400,12796,1813
1600000US0615044,0615044,"Compton city, California",24303,1459,12809,1502,11494,1489
1600000US0616000,0616000,"Concord city, California",44705,2192,27126,2484,17579,1910
1600000US0616350,0616350,"Corona city, California",43598,1964,28526,2042,15072,1786
1600000US0616532,0616532,"Costa Mesa city, California",39391,2057,16914,1613,22477,1786
1600000US0617918,0617918,"Daly City city, California",30351,1942,15931,1800,14420,1311
1600000US0618100,0618100,"Davis city, California",23434,2976,11382,1975,12052,2428
1600000US0619766,0619766,"Downey city, California",34108,1914,16882,1365,17226,1896
1600000US0620802,0620802,"East Los Angeles CDP, California",31027,2055,11267,1514,19760,1784
1600000US0621712,0621712,"El Cajon city, California",29599,1682,10643,1320,18956,1417
1600000US0622020,0622020,"Elk Grove city, California",49300,2302,36558,2283,12742,1857
1600000US0622230,0622230,"El Monte city, California",27780,1756,10676,1464,17104,1828
1600000US0622804,0622804,"Escondido city, California",43385,3795,21011,2346,22374,2309
1600000US0623182,0623182,"Fairfield city, California",34404,1554,20600,1876,13804,1524
1600000US0624638,0624638,"Folsom city, California",22381,1127,15350,1212,7031,1075
1600000US0624680,0624680,"Fontana city, California",49290,2205,33889,2267,15401,1857
1600000US0626000,0626000,"Fremont city, California",71078,2099,46153,2515,24925,2319
1600000US0627000,0627000,"Fresno city, California",152890,3242,74995,3481,77895,3201
1600000US0628000,0628000,"Fullerton city, California",42935,1935,23196,1842,19739,1413
1600000US0629000,0629000,"Garden Grove city, California",45622,1726,26801,1762,18821,1688
1600000US0630000,0630000,"Glendale city, California",68191,2576,27020,1738,41171,2466
1600000US0632548,0632548,"Hawthorne city, California",28889,1938,7224,1070,21665,1941
1600000US0633000,0633000,"Hayward city, California",43335,2121,22919,1927,20416,1950
1600000US0633182,0633182,"Hemet city, California",29954,1845,18406,2083,11548,1644
1600000US0633434,0633434,"Hesperia city, California",26411,1944,17085,1809,9326,1289
1600000US0636000,0636000,"Huntington Beach city, California",74874,2244,44872,2663,30002,2155
1600000US0636448,0636448,"Indio city, California",24519,1644,16558,1789,7961,1230
1600000US0636546,0636546,"Inglewood city, California",34712,1549,12982,1347,21730,1696
1600000US0636770,0636770,"Irvine city, California",76172,2460,38163,2550,38009,2360
1600000US0639496,0639496,"Lake Forest city, California",26602,1471,18428,1685,8174,1368
1600000US0639892,0639892,"Lakewood city, California",26485,1293,19285,1311,7200,1077
1600000US0640130,0640130,"Lancaster city, California",47466,2210,28492,2222,18974,1871
1600000US0641992,0641992,"Livermore city, California",29848,1492,20432,1733,9416,1420
1600000US0643000,0643000,"Long Beach city, California",158386,4102,62682,2749,95704,4121
1600000US0644000,0644000,"Los Angeles city, California",1310259,9520,493028,7998,817231,11253
1600000US0644574,0644574,"Lynwood city, California",15511,1025,7251,1126,8260,1047
1600000US0645484,0645484,"Manteca city, California",22451,1607,12998,1763,9453,1160
1600000US0646842,0646842,"Menifee city, California",28225,1654,22975,2008,5250,1233
1600000US0646898,0646898,"Merced city, California",23350,1589,9944,1568,13406,1535
1600000US0647766,0647766,"Milpitas city, California",19127,1269,12068,1621,7059,1089
1600000US0648256,0648256,"Mission Viejo city, California",33734,1471,25914,1603,7820,1242
1600000US0648354,0648354,"Modesto city, California",69452,1946,38271,2332,31181,2013
1600000US0649270,0649270,"Moreno Valley city, California",49040,1864,30109,1919,18931,2020
1600000US0649670,0649670,"Mountain View city, California",32019,1727,13313,1421,18706,1614
1600000US0650076,0650076,"Murrieta city, California",30651,1848,21240,1584,9411,1428
1600000US0650258,0650258,"Napa city, California",28681,1640,16706,1700,11975,1583
1600000US0651182,0651182,"Newport Beach city, California",38449,1651,21476,1615,16973,1580
1600000US0652526,0652526,"Norwalk city, California",27796,1464,17584,1589,10212,1332
1600000US0653000,0653000,"Oakland city, California",151808,3746,61547,3357,90261,3525
1600000US0653322,0653322,"Oceanside city, California",55896,2321,32138,2277,23758,2123
1600000US0653896,0653896,"Ontario city, California",42752,2482,22765,2057,19987,2292
1600000US0653980,0653980,"Orange city, California",41986,3063,23419,2427,18567,2016
1600000US0654652,0654652,"Oxnard city, California",49059,2881,25641,2459,23418,1942
1600000US0655156,0655156,"Palmdale city, California",40215,1790,27761,1845,12454,1377
1600000US0656000,0656000,"Pasadena city, California",50821,3192,22874,2310,27947,2186
1600000US0656700,0656700,"Perris city, California",15621,989,10281,1098,5340,1041
1600000US0657456,0657456,"Pittsburg city, California",18231,1137,10804,1215,7427,1108
1600000US0657792,0657792,"Pleasanton city, California",23226,1356,15797,1269,7429,1230
1600000US0658072,0658072,"Pomona city, California",36638,1878,18756,1785,17882,1732
1600000US0659451,0659451,"Rancho Cucamonga city, California",54752,2457,36141,2365,18611,2080
1600000US0659920,0659920,"Redding city, California",33646,2397,18396,1924,15250,2049
1600000US0659962,0659962,"Redlands city, California",23736,1731,15209,1589,8527,1167
1600000US0660018,0660018,"Redondo Beach city, California",29277,1975,14231,1734,15046,1716
1600000US0660102,0660102,"Redwood City city, California",26963,1518,14604,1610,12359,1147
1600000US0660466,0660466,"Rialto city, California",23707,1477,14906,1518,8801,1452
1600000US0660620,0660620,"Richmond city, California",36033,1842,17530,1734,18503,1607
1600000US0662000,0662000,"Riverside city, California",87752,3694,50025,2848,37727,3009
1600000US0662938,0662938,"Roseville city, California",44079,1913,29155,2092,14924,1860
1600000US0664000,0664000,"Sacramento city, California",176168,5046,86950,4208,89218,4095
1600000US0664224,0664224,"Salinas city, California",40933,1550,17741,1851,23192,2036
1600000US0665000,0665000,"San Bernardino city, California",59604,2858,30377,2435,29227,2299
1600000US0665042,0665042,"San Buenaventura (Ventura) city, California",40665,2172,22894,2097,17771,1588
1600000US0666000,0666000,"San Diego city, California",469635,6664,224874,5989,244761,5517
1600000US0667000,0667000,"San Francisco city, California",336012,4358,123128,4317,212884,5751
1600000US0668000,0668000,"San Jose city, California",297637,4429,173280,4849,124357,4860
1600000US0668084,0668084,"San Leandro city, California",29940,1618,17651,1480,12289,1769
1600000US0668196,0668196,"San Marcos city, California",26457,1413,15212,1335,11245,1660
1600000US0668252,0668252,"San Mateo city, California",39516,2368,20921,1838,18595,1775
1600000US0668378,0668378,"San Ramon city, California",25864,1389,17575,1645,8289,1494
1600000US0669000,0669000,"Santa Ana city, California",71288,2600,33884,2319,37404,2120
1600000US0669070,0669070,"Santa Barbara city, California",33220,2038,14389,1543,18831,1682
1600000US0669084,0669084,"Santa Clara city, California",41419,2187,18435,1651,22984,1744
1600000US0669088,0669088,"Santa Clarita city, California",60079,2468,42327,2442,17752,1950
1600000US0669196,0669196,"Santa Maria city, California",27948,1773,14777,1587,13171,1325
1600000US0670000,0670000,"Santa Monica city, California",44513,3275,12399,1445,32114,3078
1600000US0670098,0670098,"Santa Rosa city, California",61327,2549,32585,2154,28742,1851
1600000US0672016,0672016,"Simi Valley city, California",41770,1597,29462,1746,12308,1519
1600000US0673080,0673080,"South Gate city, California",23488,1337,10884,1173,12604,1522
1600000US0675000,0675000,"Stockton city, California",91200,2669,47779,2647,43421,2736
1600000US0677000,0677000,"Sunnyvale city, California",53388,2162,25349,1866,28039,2103
1600000US0678120,0678120,"Temecula city, California",31261,1820,21602,1805,9659,1441
1600000US0678582,0678582,"Thousand Oaks city, California",45316,1520,32070,2049,13246,1597
1600000US0680000,0680000,"Torrance city, California",53648,2424,31599,2443,22049,2123
1600000US0680238,0680238,"Tracy city, California",25809,1565,16533,1785,9276,1473
1600000US0680812,0680812,"Turlock city, California",23960,1323,14438,1584,9522,1214
1600000US0680854,0680854,"Tustin city, California",24057,1210,12415,1246,11642,1156
1600000US0681204,0681204,"Union City city, California",20822,1290,13756,1496,7066,1012
1600000US0681344,0681344,"Upland city, California",25870,1699,15460,1504,10410,1502
1600000US0681554,0681554,"Vacaville city, California",28430,2743,18168,2179,10262,1545
1600000US0681666,0681666,"Vallejo city, California",41042,1852,23834,1726,17208,1894
1600000US0682590,0682590,"Victorville city, California",31689,1796,18941,2005,12748,1518
1600000US0682954,0682954,"Visalia city, California",40709,2104,25041,1777,15668,1905
1600000US0682996,0682996,"Vista city, California",29982,1899,15799,1779,14183,1544
1600000US0684200,0684200,"West Covina city, California",31286,1738,18826,1839,12460,1577
1600000US0684550,0684550,"Westminster city, California",26838,1402,14627,1269,12211,1349
1600000US0685292,0685292,"Whittier city, California",27969,1935,15020,1510,12949,1546
1600000US0686832,0686832,"Yorba Linda city, California",21292,1090,17807,1121,3485,934
1600000US0803455,0803455,"Arvada city, Colorado",42551,1355,30875,1828,11676,1383
1600000US0804000,0804000,"Aurora city, Colorado",119559,3177,72736,3039,46823,2368
1600000US0807850,0807850,"Boulder city, Colorado",39893,2477,18716,1841,21177,1873
1600000US0812815,0812815,"Centennial city, Colorado",38946,1544,32394,2017,6552,1272
1600000US0816000,0816000,"Colorado Springs city, Colorado",167361,3084,97971,3063,69390,3422
1600000US0820000,0820000,"Denver city, Colorado",262093,3662,131790,3587,130303,4330
1600000US0827425,0827425,"Fort Collins city, Colorado",54989,2354,30623,2008,24366,1914
1600000US0832155,0832155,"Greeley city, Colorado",33464,2020,19402,1696,14062,1518
1600000US0836410,0836410,"Highlands Ranch CDP, Colorado",33242,1508,27424,1620,5818,1231
1600000US0843000,0843000,"Lakewood city, Colorado",60584,2346,35990,1943,24594,2031
1600000US0845970,0845970,"Longmont city, Colorado",33777,1327,20707,1390,13070,1479
1600000US0846465,0846465,"Loveland city, Colorado",27117,1495,17258,1678,9859,1470
1600000US0862000,0862000,"Pueblo city, Colorado",43641,1546,26404,1597,17237,1580
1600000US0877290,0877290,"Thornton city, Colorado",40119,1839,27779,1822,12340,1525
1600000US0883835,0883835,"Westminster city, Colorado",40975,1921,26156,2057,14819,1518
1600000US0908000,0908000,"Bridgeport city, Connecticut",48088,2001,20712,1949,27376,1915
1600000US0918430,0918430,"Danbury city, Connecticut",29546,1591,17868,1977,11678,1606
1600000US0937000,0937000,"Hartford city, Connecticut",46376,2594,10287,1282,36089,2437
1600000US0950370,0950370,"New Britain city, Connecticut",28231,1427,11486,1457,16745,1451
1600000US0952000,0952000,"New Haven city, Connecticut",49378,2620,14445,1908,34933,2544
1600000US0955990,0955990,"Norwalk city, Connecticut",39514,1993,25143,1671,14371,2013
1600000US0973000,0973000,"Stamford city, Connecticut",43537,2287,22439,1740,21098,1776
1600000US0980000,0980000,"Waterbury city, Connecticut",41553,2096,19847,1908,21706,1902
1600000US1077580,1077580,"Wilmington city, Delaware",28284,1875,13467,1581,14817,1610
1600000US1150000,1150000,"Washington city, District of Columbia",252388,3730,107193,3924,145195,4932
1600000US1200410,1200410,"Alafaya CDP, Florida",27067,2329,16659,1724,10408,1663
1600000US1207300,1207300,"Boca Raton city, Florida",35708,2024,24716,1931,10992,1513
1600000US1207875,1207875,"Boynton Beach city, Florida",27734,2129,19280,2032,8454,1134
1600000US1208150,1208150,"Brandon CDP, Florida",38638,2584,22938,2266,15700,1893
1600000US1210275,1210275,"Cape Coral city, Florida",54609,2462,39396,2385,15213,2063
1600000US1212875,1212875,"Clearwater city, Florida",45419,3100,27410,2494,18009,2173
1600000US1214400,1214400,"Coral Springs city, Florida",39826,1814,26352,2046,13474,1573
1600000US1216475,1216475,"Davie town, Florida",31760,1558,22987,2013,8773,1445
1600000US1216725,1216725,"Deerfield Beach city, Florida",31590,1910,20194,1791,11396,1713
1600000US1217200,1217200,"Deltona city, Florida",28049,1827,23430,1903,4619,1092
1600000US1224000,1224000,"Fort Lauderdale city, Florida",72824,3288,40486,2691,32338,2381
1600000US1224125,1224125,"Fort Myers city, Florida",22653,1738,9690,1166,12963,1662
1600000US1225175,1225175,"Gainesville city, Florida",45044,2692,18285,1746,26759,2410
1600000US1230000,1230000,"Hialeah city, Florida",68501,2550,36174,2554,32327,2592
1600000US1232000,1232000,"Hollywood city, Florida",55597,2604,33573,2364,22024,2336
1600000US1235000,1235000,"Jacksonville city, Florida",308173,6302,190954,5481,117219,5819
1600000US1236100,1236100,"Kendall CDP, Florida",28651,2198,18911,1792,9740,1713
1600000US1238250,1238250,"Lakeland city, Florida",39153,2371,21742,1921,17411,1936
1600000US1239425,1239425,"Largo city, Florida",35138,1914,21449,1750,13689,1772
1600000US1239550,1239550,"Lauderhill city, Florida",22585,1372,13596,1432,8989,1393
1600000US1239925,1239925,"Lehigh Acres CDP, Florida",25070,2102,16948,1975,8122,1555
1600000US1243975,1243975,"Melbourne city, Florida",32446,2148,20719,2147,11727,1425
1600000US1245000,1245000,"Miami city, Florida",145822,4810,47978,3345,97844,4117
1600000US1245025,1245025,"Miami Beach city, Florida",43034,2829,17267,2132,25767,2345
1600000US1245060,1245060,"Miami Gardens city, Florida",29672,1691,19205,1588,10467,1407
1600000US1245975,1245975,"Miramar city, Florida",35156,2280,25992,2563,9164,1661
1600000US1253000,1253000,"Orlando city, Florida",96753,3793,38569,2955,58184,3480
1600000US1254000,1254000,"Palm Bay city, Florida",35197,1745,26028,1778,9169,1368
1600000US1254200,1254200,"Palm Coast city, Florida",27503,1914,22231,1557,5272,1380
1600000US1255775,1255775,"Pembroke Pines city, Florida",54641,2390,40749,2009,13892,1804
1600000US1257425,1257425,"Plantation city, Florida",35807,1968,23778,2094,12029,1489
1600000US1258050,1258050,"Pompano Beach city, Florida",40598,2522,23481,2258,17117,2001
1600000US1258715,1258715,"Port St. Lucie city, Florida",59372,2405,46779,2577,12593,1502
1600000US1260950,1260950,"Riverview CDP, Florida",22819,2078,17775,1669,5044,1314
1600000US1263000,1263000,"St. Petersburg city, Florida",105816,3472,67102,3076,38714,2739
1600000US1268350,1268350,"Spring Hill CDP, Florida",37992,1773,30527,1736,7465,1513
1600000US1269700,1269700,"Sunrise city, Florida",30980,1569,23111,1709,7869,1339
1600000US1270600,1270600,"Tallahassee city, Florida",72716,2918,31562,2180,41154,3336
1600000US1271000,1271000,"Tampa city, Florida",133070,3857,67733,3405,65337,3492
1600000US1272145,1272145,"Town 'n' Country CDP, Florida",29859,2406,18024,1844,11835,1750
1600000US1276582,1276582,"Weston city, Florida",21282,1262,14878,1823,6404,1278
1600000US1276600,1276600,"West Palm Beach city, Florida",41661,2543,22235,2029,19426,2232
1600000US1301052,1301052,"Albany city, Georgia",29469,1816,11807,1311,17662,1525
1600000US1303440,1303440,"Athens-Clarke County unified government (balance), Georgia",39329,2422,18112,1489,21217,2168
1600000US1304000,1304000,"Atlanta city, Georgia",172159,5268,76417,3983,95742,3914
1600000US1304204,1304204,"Augusta-Richmond County consolidated government (balance), Georgia",70655,2921,39924,2449,30731,2394
1600000US1319000,1319000,"Columbus city, Georgia",72407,2555,39184,2044,33223,2250
1600000US1342425,1342425,"Johns Creek city, Georgia",25162,1486,20242,1849,4920,1124
1600000US1349000,1349000,"Macon city, Georgia",34664,1765,16543,1642,18121,1904
1600000US1367284,1367284,"Roswell city, Georgia",34881,1903,23379,1769,11502,1774
1600000US1368516,1368516,"Sandy Springs city, Georgia",39986,2117,19368,1707,20618,1955
1600000US1369000,1369000,"Savannah city, Georgia",52141,3490,23802,2284,28339,3037
1600000US1380508,1380508,"Warner Robins city, Georgia",25046,1411,14191,1237,10855,1413
1600000US1571550,1571550,"Urban Honolulu CDP, Hawaii",129012,3920,57052,2801,71960,3760
1600000US1608830,1608830,"Boise City city, Idaho",87225,2196,50956,2321,36269,2503
1600000US1652120,1652120,"Meridian city, Idaho",26032,1364,19653,1695,6379,1314
1600000US1656260,1656260,"Nampa city, Idaho",25757,1891,17070,1777,8687,1283
1600000US1702154,1702154,"Arlington Heights village, Illinois",32204,1651,24318,1673,7886,1368
1600000US1703012,1703012,"Aurora city, Illinois",59663,2115,40911,2267,18752,2065
1600000US1706613,1706613,"Bloomington city, Illinois",29314,1694,18972,1638,10342,1457
1600000US1707133,1707133,"Bolingbrook village, Illinois",21974,1470,18880,1403,3094,971
1600000US1712385,1712385,"Champaign city, Illinois",31101,4018,14615,1961,16486,2848
1600000US1714000,1714000,"Chicago city, Illinois",1014576,8579,465248,8385,549328,8469
1600000US1714351,1714351,"Cicero town, Illinois",22037,1301,11587,1160,10450,1479
1600000US1718823,1718823,"Decatur city, Illinois",31966,1548,19363,1378,12603,1366
1600000US1723074,1723074,"Elgin city, Illinois",35124,1844,26105,1974,9019,1414
1600000US1724582,1724582,"Evanston city, Illinois",27908,1653,15334,1535,12574,1741
1600000US1738570,1738570,"Joliet city, Illinois",48208,1926,32960,1808,15248,1514
1600000US1751622,1751622,"Naperville city, Illinois",49387,2096,36215,2148,13172,1704
1600000US1757225,1757225,"Palatine village, Illinois",25243,1215,18168,1370,7075,1134
1600000US1759000,1759000,"Peoria city, Illinois",46537,2603,26962,2714,19575,1658
1600000US1765000,1765000,"Rockford city, Illinois",55901,2124,32366,1983,23535,1737
1600000US1768003,1768003,"Schaumburg village, Illinois",29534,1593,18346,1490,11188,1416
1600000US1770122,1770122,"Skokie village, Illinois",23281,1620,16663,1540,6618,1231
1600000US1772000,1772000,"Springfield city, Illinois",51879,1767,33157,1747,18722,1919
1600000US1779293,1779293,"Waukegan city, Illinois",28382,1931,14644,1203,13738,1611
1600000US1805860,1805860,"Bloomington city, Indiana",30753,2041,11202,995,19551,2017
1600000US1810342,1810342,"Carmel city, Indiana",28966,1426,23107,1422,5859,1166
1600000US1822000,1822000,"Evansville city, Indiana",50307,1725,28027,1933,22280,2019
1600000US1823278,1823278,"Fishers town, Indiana",26560,1545,22148,1543,4412,1135
1600000US1825000,1825000,"Fort Wayne city, Indiana",99370,3016,63687,2780,35683,2316
1600000US1827000,1827000,"Gary city, Indiana",30108,2593,15188,1880,14920,1700
1600000US1831000,1831000,"Hammond city, Indiana",30130,1753,17788,1641,12342,1669
1600000US1836003,1836003,"Indianapolis city (balance), Indiana",322700,5582,183332,4460,139368,4553
1600000US1840788,1840788,"Lafayette city, Indiana",28651,1446,14523,1254,14128,1649
1600000US1851876,1851876,"Muncie city, Indiana",27672,1672,13716,1303,13956,1432
1600000US1871000,1871000,"South Bend city, Indiana",40543,1958,23827,1623,16716,1458
1600000US1912000,1912000,"Cedar Rapids city, Iowa",54527,1691,37727,1750,16800,1629
1600000US1919000,1919000,"Davenport city, Iowa",41017,1667,26630,1535,14387,1548
1600000US1921000,1921000,"Des Moines city, Iowa",82391,2242,52148,2201,30243,2272
1600000US1938595,1938595,"Iowa City city, Iowa",28400,1583,13730,1356,14670,1466
1600000US1973335,1973335,"Sioux City city, Iowa",31454,1425,19557,1408,11897,1398
1600000US1982425,1982425,"Waterloo city, Iowa",28040,1147,16967,1337,11073,1206
1600000US2036000,2036000,"Kansas City city, Kansas",50825,1698,31430,1896,19395,1763
1600000US2038900,2038900,"Lawrence city, Kansas",35905,2349,15008,1409,20897,2147
1600000US2052575,2052575,"Olathe city, Kansas",43823,1720,31079,1808,12744,1489
1600000US2053775,2053775,"Overland Park city, Kansas",71979,2559,47586,2121,24393,1960
1600000US2071000,2071000,"Topeka city, Kansas",54845,1718,29892,2017,24953,1781
1600000US2079000,2079000,"Wichita city, Kansas",149648,2521,92297,2886,57351,3195
1600000US2146027,2146027,"Lexington-Fayette urban county, Kentucky",120761,2746,65391,2792,55370,3009
1600000US2148006,2148006,"Louisville/Jefferson County metro government (balance), Kentucky",243140,3430,148251,3760,94889,4140
1600000US2205000,2205000,"Baton Rouge city, Louisiana",89214,2698,44510,2542,44704,2817
1600000US2239475,2239475,"Kenner city, Louisiana",24285,1616,15184,1343,9101,1354
1600000US2240735,2240735,"Lafayette city, Louisiana",48322,2489,27791,2076,20531,2272
1600000US2241155,2241155,"Lake Charles city, Louisiana",29494,1835,18245,1723,11249,1631
1600000US2250115,2250115,"Metairie CDP, Louisiana",57004,2539,35717,2059,21287,2173
1600000US2255000,2255000,"New Orleans city, Louisiana",142093,3457,71457,2896,70636,4016
1600000US2270000,2270000,"Shreveport city, Louisiana",78280,2625,43317,2505,34963,2681
1600000US2360545,2360545,"Portland city, Maine",30511,1679,14504,1385,16007,1453
1600000US2404000,2404000,"Baltimore city, Maryland",237945,4515,109283,3391,128662,4596
1600000US2419125,2419125,"Columbia CDP, Maryland",40887,2136,27962,2035,12925,1859
1600000US2426000,2426000,"Ellicott City CDP, Maryland",23781,1664,17264,1207,6517,1257
1600000US2430325,2430325,"Frederick city, Maryland",26704,1441,14983,1391,11721,1418
1600000US2432025,2432025,"Germantown CDP, Maryland",30148,2327,20531,1854,9617,1457
1600000US2472450,2472450,"Silver Spring CDP, Maryland",30525,2047,11007,1081,19518,1662
1600000US2481175,2481175,"Waldorf CDP, Maryland",24057,1526,16706,1404,7351,1422
1600000US2507000,2507000,"Boston city, Massachusetts",251721,4587,81770,3771,169951,4734
1600000US2509000,2509000,"Brockton city, Massachusetts",33460,1739,19527,1705,13933,1592
1600000US2511000,2511000,"Cambridge city, Massachusetts",47002,2573,16093,1646,30909,2476
1600000US2523000,2523000,"Fall River city, Massachusetts",38990,1621,14231,1503,24759,1894
1600000US2524960,2524960,"Framingham CDP, Massachusetts",24849,1898,14550,1521,10299,1443
1600000US2534550,2534550,"Lawrence city, Massachusetts",26829,1382,8142,1389,18687,1700
1600000US2537000,2537000,"Lowell city, Massachusetts",38036,1947,18177,1642,19859,1858
1600000US2537490,2537490,"Lynn city, Massachusetts",33000,1977,14254,1454,18746,1717
1600000US2545000,2545000,"New Bedford city, Massachusetts",38741,1707,16003,1385,22738,1849
1600000US2545560,2545560,"Newton city, Massachusetts",30408,1770,22309,1634,8099,1288
1600000US2555745,2555745,"Quincy city, Massachusetts",41459,2281,19737,1590,21722,2070
1600000US2562535,2562535,"Somerville city, Massachusetts",30468,1684,8931,1278,21537,1736
1600000US2567000,2567000,"Springfield city, Massachusetts",55088,2025,26939,1908,28149,2100
1600000US2582000,2582000,"Worcester city, Massachusetts",69278,3430,31939,2207,37339,2944
1600000US2603000,2603000,"Ann Arbor city, Michigan",43348,3072,19904,1798,23444,2233
1600000US2621000,2621000,"Dearborn city, Michigan",33315,1480,22963,1728,10352,1217
1600000US2622000,2622000,"Detroit city, Michigan",255201,5059,135864,4539,119337,4477
1600000US2627440,2627440,"Farmington Hills city, Michigan",35209,1737,20385,1439,14824,1502
1600000US2629000,2629000,"Flint city, Michigan",40827,2336,22934,1981,17893,1902
1600000US2634000,2634000,"Grand Rapids city, Michigan",68420,2333,38821,2115,29599,2028
1600000US2642160,2642160,"Kalamazoo city, Michigan",28181,1880,13916,1290,14265,1522
1600000US2646000,2646000,"Lansing city, Michigan",48949,1551,27074,1845,21875,1946
1600000US2649000,2649000,"Livonia city, Michigan",36042,1726,30855,1743,5187,929
1600000US2669035,2669035,"Rochester Hills city, Michigan",27521,1230,21409,1294,6112,946
1600000US2674900,2674900,"Southfield city, Michigan",31527,2148,16869,1441,14658,1742
1600000US2676460,2676460,"Sterling Heights city, Michigan",49318,1886,38067,1863,11251,1530
1600000US2680700,2680700,"Troy city, Michigan",31316,1151,22406,1230,8910,1147
1600000US2684000,2684000,"Warren city, Michigan",51786,2225,38710,2250,13076,1568
1600000US2686000,2686000,"Westland city, Michigan",35518,1847,20850,1688,14668,1711
1600000US2688940,2688940,"Wyoming city, Michigan",28119,1475,18265,1608,9854,1655
1600000US2706616,2706616,"Bloomington city, Minnesota",35669,1572,25141,1648,10528,1271
1600000US2707966,2707966,"Brooklyn Park city, Minnesota",24916,1633,17835,1488,7081,1184
1600000US2717000,2717000,"Duluth city, Minnesota",36814,1620,21887,1401,14927,1630
1600000US2743000,2743000,"Minneapolis city, Minnesota",165798,3861,82288,3562,83510,3467
1600000US2751730,2751730,"Plymouth city, Minnesota",27088,1630,20315,1571,6773,927
1600000US2754880,2754880,"Rochester city, Minnesota",43057,1289,31354,1439,11703,1168
1600000US2756896,2756896,"St. Cloud city, Minnesota",26542,1519,14398,1282,12144,1398
1600000US2758000,2758000,"St. Paul city, Minnesota",110088,2941,56517,2748,53571,2520
1600000US2829700,2829700,"Gulfport city, Mississippi",24439,1804,13631,1392,10808,1473
1600000US2836000,2836000,"Jackson city, Mississippi",61364,2334,33170,2248,28194,1973
1600000US2915670,2915670,"Columbia city, Missouri",43561,1916,20215,1623,23346,1673
1600000US2935000,2935000,"Independence city, Missouri",47254,2541,29753,2097,17501,1957
1600000US2938000,2938000,"Kansas City city, Missouri",188910,3973,107357,3853,81553,3209
1600000US2941348,2941348,"Lee's Summit city, Missouri",34396,1709,26342,1523,8054,1447
1600000US2954074,2954074,"O'Fallon city, Missouri",26949,1256,21941,1346,5008,1058
1600000US2964082,2964082,"St. Charles city, Missouri",28178,1484,18091,1964,10087,1653
1600000US2964550,2964550,"St. Joseph city, Missouri",28875,1829,17297,1486,11578,1540
1600000US2965000,2965000,"St. Louis city, Missouri",142152,3236,64269,2719,77883,3494
1600000US2970000,2970000,"Springfield city, Missouri",69350,2085,34317,2006,35033,2416
1600000US3006550,3006550,"Billings city, Montana",43807,1671,28571,2058,15236,1714
1600000US3050200,3050200,"Missoula city, Montana",28171,1396,14414,1310,13757,1720
1600000US3128000,3128000,"Lincoln city, Nebraska",104286,1919,59237,2274,45049,2274
1600000US3137000,3137000,"Omaha city, Nebraska",163411,2894,95584,2846,67827,2873
1600000US3223770,3223770,"Enterprise CDP, Nevada",41734,2764,24115,2272,17619,2311
1600000US3231900,3231900,"Henderson city, Nevada",99095,3059,63829,3116,35266,2258
1600000US3240000,3240000,"Las Vegas city, Nevada",210950,4737,113974,4344,96976,4369
1600000US3251800,3251800,"North Las Vegas city, Nevada",64120,2821,35920,2650,28200,2563
1600000US3254600,3254600,"Paradise CDP, Nevada",85056,3553,35880,2832,49176,3053
1600000US3260600,3260600,"Reno city, Nevada",89372,2736,41155,2419,48217,2460
1600000US3268400,3268400,"Sparks city, Nevada",33120,2239,18640,2112,14480,1846
1600000US3268585,3268585,"Spring Valley CDP, Nevada",68712,2603,34105,2182,34607,2346
1600000US3271400,3271400,"Sunrise Manor CDP, Nevada",58712,3111,32613,2562,26099,2764
1600000US3345140,3345140,"Manchester city, New Hampshire",45614,1773,22890,1772,22724,1765
1600000US3350260,3350260,"Nashua city, New Hampshire",32379,3327,18768,2217,13611,1928
1600000US3410000,3410000,"Camden city, New Jersey",24760,1525,10100,1330,14660,1255
1600000US3413690,3413690,"Clifton city, New Jersey",27273,1915,16384,1568,10889,1572
1600000US3419390,3419390,"East Orange city, New Jersey",23910,1804,7027,1084,16883,1784
1600000US3421000,3421000,"Elizabeth city, New Jersey",38320,1869,11011,1494,27309,2137
1600000US3436000,3436000,"Jersey City city, New Jersey",92649,2709,28744,2462,63905,2803
1600000US3451000,3451000,"Newark city, New Jersey",91414,3236,21695,1932,69719,3090
1600000US3456550,3456550,"Passaic city, New Jersey",20102,1478,4372,968,15730,1567
1600000US3457000,3457000,"Paterson city, New Jersey",45081,1868,12966,1535,32115,1977
1600000US3473110,3473110,"Toms River CDP, New Jersey",32194,1694,26012,1893,6182,1169
1600000US3474000,3474000,"Trenton city, New Jersey",28095,1603,12094,1568,16001,1517
1600000US3474630,3474630,"Union City city, New Jersey",21945,1470,4330,972,17615,1409
1600000US3502000,3502000,"Albuquerque city, New Mexico",223505,2539,133505,3890,90000,3764
1600000US3539380,3539380,"Las Cruces city, New Mexico",38430,2056,21688,1742,16742,1810
1600000US3563460,3563460,"Rio Rancho city, New Mexico",32234,1022,25515,1769,6719,1425
1600000US3570500,3570500,"Santa Fe city, New Mexico",31706,1438,19703,1464,12003,1260
1600000US3601000,3601000,"Albany city, New York",39204,2475,14091,1649,25113,2085
1600000US3611000,3611000,"Buffalo city, New York",113302,3059,46475,3033,66827,2864
1600000US3615000,3615000,"Cheektowaga CDP, New York",31703,1831,21706,1498,9997,1375
1600000US3649121,3649121,"Mount Vernon city, New York",25975,1617,9584,1410,16391,1437
1600000US3650617,3650617,"New Rochelle city, New York",27874,2190,14681,1706,13193,1519
1600000US3651000,3651000,"New York city, New York",3039467,11288,976294,11064,2063173,13509
1600000US3663000,3663000,"Rochester city, New York",85821,3040,34028,2356,51793,2848
1600000US3665508,3665508,"Schenectady city, New York",24684,1477,12239,1417,12445,1454
1600000US3673000,3673000,"Syracuse city, New York",53906,2575,20207,1763,33699,2325
1600000US3684000,3684000,"Yonkers city, New York",73616,2724,36618,2224,36998,2610
1600000US3702140,3702140,"Asheville city, North Carolina",38119,2168,19213,1764,18906,1876
1600000US3710740,3710740,"Cary town, North Carolina",50247,1847,35706,1953,14541,1940
1600000US3712000,3712000,"Charlotte city, North Carolina",284113,3643,166456,4652,117657,4443
1600000US3714100,3714100,"Concord city, North Carolina",29558,1942,21144,1691,8414,1630
1600000US3719000,3719000,"Durham city, North Carolina",92419,2796,47169,2505,45250,2699
1600000US3722920,3722920,"Fayetteville city, North Carolina",75187,3891,39716,3078,35471,3226
1600000US3725580,3725580,"Gastonia city, North Carolina",27988,1526,16602,1437,11386,1583
1600000US3728000,3728000,"Greensboro city, North Carolina",109255,3387,58373,2797,50882,3347
1600000US3728080,3728080,"Greenville city, North Carolina",33608,1935,14859,1240,18749,1954
1600000US3731400,3731400,"High Point city, North Carolina",38849,2260,21929,1870,16920,1942
1600000US3734200,3734200,"Jacksonville city, North Carolina",20206,1613,7134,1152,13072,1373
1600000US3755000,3755000,"Raleigh city, North Carolina",159935,4082,88955,3636,70980,3327
1600000US3774440,3774440,"Wilmington city, North Carolina",44398,2659,21334,2067,23064,1817
1600000US3775000,3775000,"Winston-Salem city, North Carolina",89380,2928,52190,2760,37190,2850
1600000US3825700,3825700,"Fargo city, North Dakota",47349,1614,20401,1716,26948,1843
1600000US3901000,3901000,"Akron city, Ohio",82046,2577,44988,2529,37058,2290
1600000US3912000,3912000,"Canton city, Ohio",29286,1663,16154,1646,13132,1389
1600000US3915000,3915000,"Cincinnati city, Ohio",126145,4336,53430,3174,72715,3699
1600000US3916000,3916000,"Cleveland city, Ohio",164990,4095,77462,3356,87528,3312
1600000US3918000,3918000,"Columbus city, Ohio",319428,4797,151463,4653,167965,5745
1600000US3921000,3921000,"Dayton city, Ohio",57997,2585,30022,2069,27975,2250
1600000US3944856,3944856,"Lorain city, Ohio",24916,1510,14584,1281,10332,1325
1600000US3961000,3961000,"Parma city, Ohio",32493,1739,25312,1880,7181,1300
1600000US3977000,3977000,"Toledo city, Ohio",116064,2598,66253,2218,49811,3028
1600000US3988000,3988000,"Youngstown city, Ohio",27673,1651,17392,1443,10281,1171
1600000US4009050,4009050,"Broken Arrow city, Oklahoma",35620,1692,28557,1884,7063,1212
1600000US4023200,4023200,"Edmond city, Oklahoma",29370,1466,20393,1257,8977,1216
1600000US4041850,4041850,"Lawton city, Oklahoma",35891,1814,16997,1550,18894,1939
1600000US4052500,4052500,"Norman city, Oklahoma",43020,2899,24163,2220,18857,2155
1600000US4055000,4055000,"Oklahoma City city, Oklahoma",223238,3973,137176,3746,86062,3545
1600000US4075000,4075000,"Tulsa city, Oklahoma",163173,2981,88872,3044,74301,3680
1600000US4105350,4105350,"Beaverton city, Oregon",36661,1749,18694,1685,17967,2134
1600000US4105800,4105800,"Bend city, Oregon",32865,1804,19815,1779,13050,1577
1600000US4123850,4123850,"Eugene city, Oregon",66437,2926,34152,2358,32285,2511
1600000US4131250,4131250,"Gresham city, Oregon",39658,2144,20750,1726,18908,1987
1600000US4134100,4134100,"Hillsboro city, Oregon",30868,1826,17539,1557,13329,1448
1600000US4147000,4147000,"Medford city, Oregon",29650,1553,16355,1564,13295,1557
1600000US4159000,4159000,"Portland city, Oregon",244192,3559,129761,2956,114431,3189
1600000US4164900,4164900,"Salem city, Oregon",59160,2250,34601,2355,24559,2036
1600000US4202000,4202000,"Allentown city, Pennsylvania",44013,1909,19826,1815,24187,2097
1600000US4206088,4206088,"Bethlehem city, Pennsylvania",29349,1605,15183,1546,14166,1486
1600000US4224000,4224000,"Erie city, Pennsylvania",41017,1947,20171,1755,20846,1640
1600000US4260000,4260000,"Philadelphia city, Pennsylvania",575413,6623,311284,6713,264129,6251
1600000US4261000,4261000,"Pittsburgh city, Pennsylvania",129828,3843,66693,2965,63135,3070
1600000US4263624,4263624,"Reading city, Pennsylvania",31357,1637,13405,1473,17952,1568
1600000US4269000,4269000,"Scranton city, Pennsylvania",30123,1704,16471,1067,13652,1556
1600000US4419180,4419180,"Cranston city, Rhode Island",29595,1929,20142,1784,9453,1573
1600000US4454640,4454640,"Pawtucket city, Rhode Island",29638,1882,13387,1209,16251,1655
1600000US4459000,4459000,"Providence city, Rhode Island",57037,2557,20891,2284,36146,2326
1600000US4474300,4474300,"Warwick city, Rhode Island",35651,1582,25260,1420,10391,1462
1600000US4513330,4513330,"Charleston city, South Carolina",51818,2723,26744,2248,25074,2199
1600000US4516000,4516000,"Columbia city, South Carolina",47290,2981,22427,2271,24863,1912
1600000US4548535,4548535,"Mount Pleasant town, South Carolina",27243,1292,20045,1458,7198,1024
1600000US4550875,4550875,"North Charleston city, South Carolina",34048,2096,15961,1730,18087,1743
1600000US4561405,4561405,"Rock Hill city, South Carolina",24858,1543,13051,1596,11807,1455
1600000US4652980,4652980,"Rapid City city, South Dakota",30094,1170,17312,1283,12782,1160
1600000US4659020,4659020,"Sioux Falls city, South Dakota",61906,2557,37402,2113,24504,2032
1600000US4714000,4714000,"Chattanooga city, Tennessee",71098,2066,38092,2315,33006,2455
1600000US4715160,4715160,"Clarksville city, Tennessee",47005,1850,27621,1983,19384,2062
1600000US4737640,4737640,"Jackson city, Tennessee",22538,1547,12414,1210,10124,1213
1600000US4740000,4740000,"Knoxville city, Tennessee",83212,2873,42777,2606,40435,2757
1600000US4748000,4748000,"Memphis city, Tennessee",241400,4203,125745,3852,115655,4165
1600000US4751560,4751560,"Murfreesboro city, Tennessee",40659,1880,21450,1976,19209,1855
1600000US4752006,4752006,"Nashville-Davidson metropolitan government (balance), Tennessee",240618,3809,128981,4011,111637,3949
1600000US4801000,4801000,"Abilene city, Texas",42530,2124,23250,1656,19280,2195
1600000US4801924,4801924,"Allen city, Texas",28514,1384,21309,1713,7205,1375
1600000US4803000,4803000,"Amarillo city, Texas",73269,1819,45496,2059,27773,2073
1600000US4804000,4804000,"Arlington city, Texas",133491,3094,76848,3778,56643,3541
1600000US4804462,4804462,"Atascocita CDP, Texas",22298,2031,17906,1722,4392,1390
1600000US4805000,4805000,"Austin city, Texas",323282,4713,145720,4888,177562,4479
1600000US4806128,4806128,"Baytown city, Texas",23077,1514,14677,1454,8400,1416
1600000US4807000,4807000,"Beaumont city, Texas",42856,2979,23660,2287,19196,2087
1600000US4810768,4810768,"Brownsville city, Texas",46696,2153,28448,1819,18248,2063
1600000US4810912,4810912,"Bryan city, Texas",27408,1652,13956,1514,13452,1766
1600000US4813024,4813024,"Carrollton city, Texas",42745,1941,28157,1939,14588,1698
1600000US4815976,4815976,"College Station city, Texas",33477,1869,11835,1186,21642,1845
1600000US4817000,4817000,"Corpus Christi city, Texas",110954,2722,64265,3158,46689,3377
1600000US4819000,4819000,"Dallas city, Texas",447680,6310,194231,4868,253449,6358
1600000US4819972,4819972,"Denton city, Texas",41007,2331,18867,1631,22140,2007
1600000US4822660,4822660,"Edinburg city, Texas",24065,1850,14036,1494,10029,1488
1600000US4824000,4824000,"El Paso city, Texas",210754,2612,125754,3894,85000,3859
1600000US4826232,4826232,"Flower Mound town, Texas",21919,1216,20659,1125,1260,618
1600000US4827000,4827000,"Fort Worth city, Texas",261042,5514,154043,4436,106999,4687
1600000US4827684,4827684,"Frisco city, Texas",37454,1833,29378,1909,8076,1496
1600000US4829000,4829000,"Garland city, Texas",74524,2734,48216,2331,26308,2140
1600000US4830464,4830464,"Grand Prairie city, Texas",57078,2037,35996,2520,21082,1936
1600000US4832372,4832372,"Harlingen city, Texas",21265,1692,12341,1423,8924,1635
1600000US4835000,4835000,"Houston city, Texas",762309,6535,352374,6158,409935,6689
1600000US4837000,4837000,"Irving city, Texas",80792,3159,33013,2302,47779,2869
1600000US4839148,4839148,"Killeen city, Texas",44892,1980,22902,1797,21990,1796
1600000US4841464,4841464,"Laredo city, Texas",62830,1696,37233,2125,25597,2111
1600000US4841980,4841980,"League City city, Texas",29767,1491,21867,1731,7900,1457
1600000US4842508,4842508,"Lewisville city, Texas",36870,1842,16642,1622,20228,1633
1600000US4843888,4843888,"Longview city, Texas",29520,1790,16866,1757,12654,1625
1600000US4845000,4845000,"Lubbock city, Texas",88714,2325,47991,2297,40723,2840
1600000US4845384,4845384,"McAllen city, Texas",42155,2550,25234,1751,16921,2299
1600000US4845744,4845744,"McKinney city, Texas",43306,2125,31284,2024,12022,1499
1600000US4847892,4847892,"Mesquite city, Texas",48732,2315,29146,2282,19586,1917
1600000US4848072,4848072,"Midland city, Texas",40192,2032,25695,1857,14497,1712
1600000US4848768,4848768,"Mission city, Texas",21257,1574,14761,1366,6496,1267
1600000US4848804,4848804,"Missouri City city, Texas",21435,1652,18252,1776,3183,1157
1600000US4852356,4852356,"North Richland Hills city, Texas",24978,1496,15273,1445,9705,1460
1600000US4853388,4853388,"Odessa city, Texas",35261,1486,20552,1644,14709,1599
1600000US4856000,4856000,"Pasadena city, Texas",48270,1936,28404,2179,19866,1625
1600000US4856348,4856348,"Pearland city, Texas",29856,1642,23728,1700,6128,1118
1600000US4857200,4857200,"Pharr city, Texas",19236,1138,11788,1515,7448,1459
1600000US4858016,4858016,"Plano city, Texas",97524,2960,64034,2588,33490,2835
1600000US4861796,4861796,"Richardson city, Texas",38073,1702,23152,1653,14921,1687
1600000US4863500,4863500,"Round Rock city, Texas",34092,1500,18735,1752,15357,1599
1600000US4864472,4864472,"San Angelo city, Texas",35329,1906,22476,1785,12853,1699
1600000US4865000,4865000,"San Antonio city, Texas",470223,4982,262804,4755,207419,4854
1600000US4870808,4870808,"Sugar Land city, Texas",25851,1221,20669,1567,5182,1182
1600000US4872176,4872176,"Temple city, Texas",23304,1599,14258,1336,9046,1294
1600000US4872656,4872656,"The Woodlands CDP, Texas",35227,2071,26478,1676,8749,1443
1600000US4874144,4874144,"Tyler city, Texas",39661,1857,22729,1737,16932,1855
1600000US4876000,4876000,"Waco city, Texas",44462,1964,21257,1824,23205,1959
1600000US4879000,4879000,"Wichita Falls city, Texas",37237,2003,21474,1690,15763,1887
1600000US4943660,4943660,"Layton city, Utah",21175,1190,15186,1154,5989,1081
1600000US4955980,4955980,"Ogden city, Utah",29645,1802,15657,1946,13988,1836
1600000US4957300,4957300,"Orem city, Utah",26481,1171,16655,1357,9826,1074
1600000US4962470,4962470,"Provo city, Utah",29703,1872,13009,1422,16694,1546
1600000US4965330,4965330,"St. George city, Utah",26292,1560,16963,1564,9329,1510
1600000US4967000,4967000,"Salt Lake City city, Utah",73324,3034,34903,2450,38421,2513
1600000US4967440,4967440,"Sandy city, Utah",27858,1328,21414,1427,6444,1237
1600000US4982950,4982950,"West Jordan city, Utah",29815,1403,23566,1652,6249,1202
1600000US4983470,4983470,"West Valley City city, Utah",38815,2039,26824,2028,11991,1450
1600000US5101000,5101000,"Alexandria city, Virginia",64361,2156,27709,1921,36652,2223
1600000US5103000,5103000,"Arlington CDP, Virginia",92982,2544,41310,2234,51672,2851
1600000US5114440,5114440,"Centreville CDP, Virginia",25402,1870,19125,1626,6277,1566
1600000US5116000,5116000,"Chesapeake city, Virginia",78554,1845,58369,2304,20185,2172
1600000US5121088,5121088,"Dale City CDP, Virginia",20204,1608,14633,1670,5571,1244
1600000US5135000,5135000,"Hampton city, Virginia",51301,2003,31662,1888,19639,1900
1600000US5147672,5147672,"Lynchburg city, Virginia",26613,1703,14176,1283,12437,1825
1600000US5156000,5156000,"Newport News city, Virginia",69958,4405,35492,1946,34466,3730
1600000US5157000,5157000,"Norfolk city, Virginia",83828,2539,37985,1719,45843,2759
1600000US5164000,5164000,"Portsmouth city, Virginia",37201,1385,21801,1561,15400,1406
1600000US5167000,5167000,"Richmond city, Virginia",83927,2546,37110,2274,46817,2824
1600000US5168000,5168000,"Roanoke city, Virginia",42478,1659,24049,1769,18429,1896
1600000US5176432,5176432,"Suffolk city, Virginia",30987,964,23089,1162,7898,1156
1600000US5182000,5182000,"Virginia Beach city, Virginia",164300,2574,107949,3408,56351,3577
1600000US5303180,5303180,"Auburn city, Washington",27160,1812,15934,1366,11226,1754
1600000US5305210,5305210,"Bellevue city, Washington",50378,2035,27713,1983,22665,1903
1600000US5305280,5305280,"Bellingham city, Washington",33373,1843,15006,1411,18367,1772
1600000US5322640,5322640,"Everett city, Washington",41220,2160,19045,1738,22175,2013
1600000US5323515,5323515,"Federal Way city, Washington",35660,1981,20391,1743,15269,1667
1600000US5335275,5335275,"Kennewick city, Washington",25662,1652,16264,1615,9398,1417
1600000US5335415,5335415,"Kent city, Washington",34638,2189,17077,1577,17561,1920
1600000US5357745,5357745,"Renton city, Washington",35002,2061,19665,1859,15337,1576
1600000US5363000,5363000,"Seattle city, Washington",277520,5743,130208,4120,147312,4747
1600000US5367000,5367000,"Spokane city, Washington",88795,2322,51022,2256,37773,2477
1600000US5367167,5367167,"Spokane Valley city, Washington",37045,1874,23205,2263,13840,1774
1600000US5370000,5370000,"Tacoma city, Washington",79316,2895,41780,2720,37536,2565
1600000US5374060,5374060,"Vancouver city, Washington",63620,2395,33882,2348,29738,2183
1600000US5380010,5380010,"Yakima city, Washington",33168,1866,17682,1868,15486,1762
1600000US5502375,5502375,"Appleton city, Wisconsin",28791,1716,20388,1595,8403,1454
1600000US5522300,5522300,"Eau Claire city, Wisconsin",25979,1569,15068,1272,10911,1237
1600000US5531000,5531000,"Green Bay city, Wisconsin",42004,1790,25189,1517,16815,1704
1600000US5539225,5539225,"Kenosha city, Wisconsin",38173,1801,22123,1604,16050,1664
1600000US5548000,5548000,"Madison city, Wisconsin",100903,2868,50852,2404,50051,2431
1600000US5553000,5553000,"Milwaukee city, Wisconsin",228945,3762,102660,3527,126285,3755
1600000US5560500,5560500,"Oshkosh city, Wisconsin",24721,1290,13855,1289,10866,1491
1600000US5566000,5566000,"Racine city, Wisconsin",30325,1775,16982,1576,13343,1458
1600000US5584250,5584250,"Waukesha city, Wisconsin",28591,1571,17037,1402,11554,1214
