GEO.id,GEO.id2,GEO.display-label,HD01_VD01,HD02_VD01,HD01_VD02,HD02_VD02,HD01_VD03,HD02_VD03
1600000US0107000,0107000,"Birmingham city, Alabama",86653,3073,42868,2365,43785,2625
1600000US0121184,0121184,"Dothan city, Alabama",25778,874,15375,740,10403,848
1600000US0135896,0135896,"Hoover city, Alabama",31005,2196,20662,1760,10343,1761
1600000US0137000,0137000,"Huntsville city, Alabama",76252,2879,44925,2419,31327,2329
1600000US0150000,0150000,"Mobile city, Alabama",77682,2431,46309,2479,31373,2199
1600000US0151000,0151000,"Montgomery city, Alabama",79580,3097,48110,2943,31470,2854
1600000US0177256,0177256,"Tuscaloosa city, Alabama",30100,2026,15029,1594,15071,1682
1600000US0203000,0203000,"Anchorage municipality, Alaska",106651,1720,63309,2667,43342,2554
1600000US0404720,0404720,"Avondale city, Arizona",21810,2480,13375,2546,8435,1930
1600000US0410670,0410670,"Casas Adobes CDP, Arizona",27808,1841,17233,1451,10575,1391
1600000US0412000,0412000,"Chandler city, Arizona",85727,3140,54211,3022,31516,3285
1600000US0423620,0423620,"Flagstaff city, Arizona",21534,1585,10057,1291,11477,1459
1600000US0427400,0427400,"Gilbert town, Arizona",68676,3402,47798,3621,20878,3593
1600000US0427820,0427820,"Glendale city, Arizona",79199,3152,46630,2789,32569,2376
1600000US0428380,0428380,"Goodyear city, Arizona",24695,1965,14954,2158,9741,2079
1600000US0446000,0446000,"Mesa city, Arizona",163743,4106,97837,4153,65906,3378
1600000US0454050,0454050,"Peoria city, Arizona",57921,2927,42298,2659,15623,2721
1600000US0455000,0455000,"Phoenix city, Arizona",519369,6873,286852,8006,232517,7694
1600000US0464210,0464210,"San Tan Valley CDP, Arizona",23754,2853,16256,2916,7498,2054
1600000US0465000,0465000,"Scottsdale city, Arizona",102238,3528,67504,3731,34734,3063
1600000US0471510,0471510,"Surprise city, Arizona",41858,2513,28421,3243,13437,2998
1600000US0473000,0473000,"Tempe city, Arizona",61449,3322,27678,2602,33771,2448
1600000US0477000,0477000,"Tucson city, Arizona",201841,4418,100604,3986,101237,3866
1600000US0485540,0485540,"Yuma city, Arizona",34241,2124,20877,2033,13364,2267
1600000US0523290,0523290,"Fayetteville city, Arkansas",33661,1676,12674,1568,20987,1771
1600000US0524550,0524550,"Fort Smith city, Arkansas",32993,1734,18449,1576,14544,1568
1600000US0535710,0535710,"Jonesboro city, Arkansas",26347,1271,13883,1718,12464,1696
1600000US0541000,0541000,"Little Rock city, Arkansas",81700,2813,45990,3076,35710,2597
1600000US0566080,0566080,"Springdale city, Arkansas",25088,1968,14233,2021,10855,1817
1600000US0600562,0600562,"Alameda city, California",30335,1437,15388,1494,14947,1581
1600000US0600884,0600884,"Alhambra city, California",28816,1724,11493,1246,17323,1675
1600000US0602000,0602000,"Anaheim city, California",98586,3089,45616,2873,52970,2846
1600000US0602252,0602252,"Antioch city, California",32200,1853,19339,2182,12861,1977
1600000US0602364,0602364,"Apple Valley town, California",23599,1717,17608,1640,5991,1226
1600000US0602553,0602553,"Arden-Arcade CDP, California",40255,2699,18123,1590,22132,2645
1600000US0603526,0603526,"Bakersfield city, California",108123,3091,60218,3194,47905,2878
1600000US0603666,0603666,"Baldwin Park city, California",16680,962,9832,1049,6848,824
1600000US0604982,0604982,"Bellflower city, California",22358,1098,7949,932,14409,1292
1600000US0606000,0606000,"Berkeley city, California",45338,2099,20746,1422,24592,2189
1600000US0608786,0608786,"Buena Park city, California",22487,1183,13528,1382,8959,1192
1600000US0608954,0608954,"Burbank city, California",39445,2019,15769,1574,23676,2020
1600000US0610046,0610046,"Camarillo city, California",22101,1382,15842,1333,6259,913
1600000US0611194,0611194,"Carlsbad city, California",41226,2030,24666,1981,16560,1879
1600000US0611530,0611530,"Carson city, California",24849,1455,19783,1545,5066,995
1600000US0613014,0613014,"Chico city, California",34688,1669,14890,1654,19798,1648
1600000US0613210,0613210,"Chino city, California",22161,2133,15986,1780,6175,1343
1600000US0613214,0613214,"Chino Hills city, California",22178,1639,17629,1588,4549,1115
1600000US0613392,0613392,"Chula Vista city, California",76231,2801,43536,2811,32695,2665
1600000US0613588,0613588,"Citrus Heights city, California",31170,1974,16789,1728,14381,1661
1600000US0614218,0614218,"Clovis city, California",33627,1955,21847,1839,11780,1670
1600000US0615044,0615044,"Compton city, California",22578,1095,12043,1252,10535,1199
1600000US0616000,0616000,"Concord city, California",44610,1676,27379,2114,17231,1746
1600000US0616350,0616350,"Corona city, California",44239,1692,30289,1739,13950,1390
1600000US0616532,0616532,"Costa Mesa city, California",42866,2271,15472,1437,27394,2271
1600000US0617918,0617918,"Daly City city, California",30184,1558,17198,1530,12986,1602
1600000US0618100,0618100,"Davis city, California",23483,1238,10757,1046,12726,1093
1600000US0619766,0619766,"Downey city, California",33642,1793,16866,1672,16776,1965
1600000US0620802,0620802,"East Los Angeles CDP, California",31264,2007,10873,1209,20391,1920
1600000US0621712,0621712,"El Cajon city, California",32696,2020,13129,1521,19567,1508
1600000US0622020,0622020,"Elk Grove city, California",47641,2758,33382,3085,14259,2142
1600000US0622230,0622230,"El Monte city, California",29772,1466,12632,1419,17140,1441
1600000US0622804,0622804,"Escondido city, California",44095,1987,21755,2122,22340,1858
1600000US0623182,0623182,"Fairfield city, California",32678,1597,18640,1841,14038,1431
1600000US0624477,0624477,"Florence-Graham CDP, California",15066,1285,5651,984,9415,1161
1600000US0624638,0624638,"Folsom city, California",25294,1795,16996,1985,8298,1803
1600000US0624680,0624680,"Fontana city, California",48601,2602,33580,2548,15021,1987
1600000US0626000,0626000,"Fremont city, California",70649,2524,43267,2730,27382,2571
1600000US0627000,0627000,"Fresno city, California",154747,3341,74410,2992,80337,3573
1600000US0628000,0628000,"Fullerton city, California",44570,2215,24790,2080,19780,1918
1600000US0629000,0629000,"Garden Grove city, California",45615,1930,24254,1434,21361,1786
1600000US0630000,0630000,"Glendale city, California",72301,2661,26900,2299,45401,3032
1600000US0632548,0632548,"Hawthorne city, California",28562,1747,7443,952,21119,1950
1600000US0633000,0633000,"Hayward city, California",46863,2194,24850,1791,22013,1990
1600000US0633182,0633182,"Hemet city, California",32314,2137,19066,1971,13248,1484
1600000US0633434,0633434,"Hesperia city, California",26666,1678,17049,1802,9617,1200
1600000US0636000,0636000,"Huntington Beach city, California",75686,2139,44096,2312,31590,2149
1600000US0636448,0636448,"Indio city, California",23812,2029,15263,2065,8549,1268
1600000US0636546,0636546,"Inglewood city, California",37379,1885,13951,1289,23428,1551
1600000US0636770,0636770,"Irvine city, California",75284,2652,39015,2248,36269,2636
1600000US0639496,0639496,"Lake Forest city, California",26178,1424,18696,1602,7482,1136
1600000US0639892,0639892,"Lakewood city, California",26623,1472,17889,1463,8734,1219
1600000US0640130,0640130,"Lancaster city, California",47278,2559,27396,2605,19882,2160
1600000US0641992,0641992,"Livermore city, California",28674,1347,19473,1597,9201,1271
1600000US0643000,0643000,"Long Beach city, California",160059,3803,64535,3079,95524,3441
1600000US0644000,0644000,"Los Angeles city, California",1304145,9308,481118,6863,823027,9546
1600000US0644574,0644574,"Lynwood city, California",14238,1199,7203,914,7035,882
1600000US0645484,0645484,"Manteca city, California",21111,1442,12959,1445,8152,1211
1600000US0646842,0646842,"Menifee city, California",25603,2128,20014,2545,5589,1854
1600000US0646898,0646898,"Merced city, California",24220,1387,10941,1492,13279,1346
1600000US0647766,0647766,"Milpitas city, California",19392,1060,12640,1364,6752,1203
1600000US0648256,0648256,"Mission Viejo city, California",32012,1795,23504,2015,8508,1121
1600000US0648354,0648354,"Modesto city, California",67243,2275,35748,2224,31495,2482
1600000US0649270,0649270,"Moreno Valley city, California",50633,2294,32054,1970,18579,2398
1600000US0649670,0649670,"Mountain View city, California",31943,1554,13870,1418,18073,1721
1600000US0650076,0650076,"Murrieta city, California",32182,3141,20737,3541,11445,2180
1600000US0650258,0650258,"Napa city, California",28905,1464,14576,1563,14329,1344
1600000US0651182,0651182,"Newport Beach city, California",39415,1780,20806,1527,18609,1773
1600000US0652526,0652526,"Norwalk city, California",27266,1517,17086,1625,10180,1351
1600000US0653000,0653000,"Oakland city, California",157374,3582,63161,2525,94213,3445
1600000US0653322,0653322,"Oceanside city, California",56762,2756,30364,2379,26398,2011
1600000US0653896,0653896,"Ontario city, California",46571,2156,25651,2445,20920,2912
1600000US0653980,0653980,"Orange city, California",43462,2064,26109,1818,17353,1828
1600000US0654652,0654652,"Oxnard city, California",49415,1926,27419,1917,21996,1585
1600000US0655156,0655156,"Palmdale city, California",40783,1965,24083,1730,16700,1648
1600000US0655282,0655282,"Palo Alto city, California",26849,1553,14193,1398,12656,1473
1600000US0656000,0656000,"Pasadena city, California",55045,3070,24830,2064,30215,2604
1600000US0656700,0656700,"Perris city, California",16781,1552,11475,1641,5306,1277
1600000US0657456,0657456,"Pittsburg city, California",18953,1396,10848,1211,8105,1232
1600000US0657792,0657792,"Pleasanton city, California",24333,1202,17411,1396,6922,1302
1600000US0658072,0658072,"Pomona city, California",37972,2146,20592,1742,17380,1531
1600000US0659444,0659444,"Rancho Cordova city, California",23146,1291,13200,1259,9946,1210
1600000US0659451,0659451,"Rancho Cucamonga city, California",57158,3827,38192,3752,18966,3585
1600000US0659920,0659920,"Redding city, California",35025,1413,19318,1550,15707,1479
1600000US0659962,0659962,"Redlands city, California",24990,1672,14334,1677,10656,1419
1600000US0660018,0660018,"Redondo Beach city, California",28790,1594,16009,1522,12781,1733
1600000US0660102,0660102,"Redwood City city, California",28320,1666,15716,1527,12604,1533
1600000US0660466,0660466,"Rialto city, California",23852,1881,14936,1527,8916,1427
1600000US0660620,0660620,"Richmond city, California",36373,1796,18335,1794,18038,2048
1600000US0662000,0662000,"Riverside city, California",87476,3383,49739,2949,37737,2815
1600000US0662938,0662938,"Roseville city, California",44687,2373,29195,2216,15492,2211
1600000US0664000,0664000,"Sacramento city, California",170999,4512,82503,3835,88496,4010
1600000US0664224,0664224,"Salinas city, California",41518,1806,18100,1699,23418,1875
1600000US0665000,0665000,"San Bernardino city, California",58433,2365,28079,2255,30354,2514
1600000US0665042,0665042,"San Buenaventura (Ventura) city, California",40401,1823,21544,1834,18857,1834
1600000US0666000,0666000,"San Diego city, California",468194,6110,222651,5387,245543,5636
1600000US0667000,0667000,"San Francisco city, California",342706,3616,123681,4286,219025,5653
1600000US0668000,0668000,"San Jose city, California",305460,4455,172528,4737,132932,4512
1600000US0668084,0668084,"San Leandro city, California",30627,1840,17431,1965,13196,1499
1600000US0668196,0668196,"San Marcos city, California",26053,1708,14435,1758,11618,1412
1600000US0668252,0668252,"San Mateo city, California",38380,1847,19505,1787,18875,1447
1600000US0668378,0668378,"San Ramon city, California",25120,1577,17044,1496,8076,1707
1600000US0669000,0669000,"Santa Ana city, California",73026,3038,35879,2177,37147,2785
1600000US0669070,0669070,"Santa Barbara city, California",33626,1859,13348,1467,20278,1631
1600000US0669084,0669084,"Santa Clara city, California",42398,2181,19327,1708,23071,1716
1600000US0669088,0669088,"Santa Clarita city, California",57799,1911,38842,2035,18957,1838
1600000US0669196,0669196,"Santa Maria city, California",27007,1757,13050,1355,13957,1460
1600000US0670000,0670000,"Santa Monica city, California",47181,2187,11632,1364,35549,2230
1600000US0670098,0670098,"Santa Rosa city, California",61489,2865,34487,2414,27002,2528
1600000US0672016,0672016,"Simi Valley city, California",40668,1898,30666,2051,10002,1371
1600000US0673080,0673080,"South Gate city, California",23601,1305,10448,1323,13153,1399
1600000US0675000,0675000,"Stockton city, California",89296,2669,45759,2746,43537,2372
1600000US0677000,0677000,"Sunnyvale city, California",52734,2142,24807,2003,27927,1891
1600000US0678120,0678120,"Temecula city, California",32474,2036,20767,2177,11707,1979
1600000US0678582,0678582,"Thousand Oaks city, California",46369,2272,34739,1756,11630,1683
1600000US0680000,0680000,"Torrance city, California",54670,2303,29973,2244,24697,2114
1600000US0680238,0680238,"Tracy city, California",24494,1754,15767,1850,8727,1808
1600000US0680812,0680812,"Turlock city, California",23505,1226,12588,1625,10917,1672
1600000US0680854,0680854,"Tustin city, California",24478,1589,13560,1597,10918,1404
1600000US0681204,0681204,"Union City city, California",20882,993,13223,1168,7659,1106
1600000US0681344,0681344,"Upland city, California",26977,2149,15826,2186,11151,1820
1600000US0681554,0681554,"Vacaville city, California",31879,1981,18712,1950,13167,1797
1600000US0681666,0681666,"Vallejo city, California",40152,1844,22589,1823,17563,1711
1600000US0682590,0682590,"Victorville city, California",30374,2401,18615,2653,11759,1966
1600000US0682954,0682954,"Visalia city, California",42048,1805,24913,2160,17135,1738
1600000US0682996,0682996,"Vista city, California",29827,1884,14835,1505,14992,1573
1600000US0683346,0683346,"Walnut Creek city, California",27931,1637,18431,1505,9500,1588
1600000US0684200,0684200,"West Covina city, California",32136,1537,21301,1836,10835,1356
1600000US0684550,0684550,"Westminster city, California",28550,1317,15712,1365,12838,1365
1600000US0685292,0685292,"Whittier city, California",26922,1488,14951,1451,11971,1257
1600000US0686832,0686832,"Yorba Linda city, California",22109,1113,18709,1204,3400,883
1600000US0686972,0686972,"Yuba City city, California",21943,1188,13366,1092,8577,1216
1600000US0803455,0803455,"Arvada city, Colorado",42197,1361,31777,1689,10420,1093
1600000US0804000,0804000,"Aurora city, Colorado",118405,2957,67579,3004,50826,2927
1600000US0807850,0807850,"Boulder city, Colorado",40117,1841,20901,1525,19216,1834
1600000US0812815,0812815,"Centennial city, Colorado",38270,1502,31222,1833,7048,1087
1600000US0816000,0816000,"Colorado Springs city, Colorado",167859,3051,96809,3470,71050,3561
1600000US0820000,0820000,"Denver city, Colorado",266624,2404,130009,4013,136615,4057
1600000US0827425,0827425,"Fort Collins city, Colorado",58111,2420,32565,2311,25546,2189
1600000US0832155,0832155,"Greeley city, Colorado",34298,2053,17938,2057,16360,1830
1600000US0836410,0836410,"Highlands Ranch CDP, Colorado",37002,1931,28231,1605,8771,1548
1600000US0843000,0843000,"Lakewood city, Colorado",62311,2109,35683,2185,26628,2021
1600000US0845970,0845970,"Longmont city, Colorado",33399,1651,21573,1922,11826,1611
1600000US0846465,0846465,"Loveland city, Colorado",28527,1361,17178,1720,11349,1384
1600000US0862000,0862000,"Pueblo city, Colorado",43601,1498,25198,1623,18403,1559
1600000US0877290,0877290,"Thornton city, Colorado",39696,1819,27918,1975,11778,1529
1600000US0883835,0883835,"Westminster city, Colorado",41986,1784,25072,1773,16914,1492
1600000US0908000,0908000,"Bridgeport city, Connecticut",51443,2201,20396,1766,31047,1986
1600000US0918430,0918430,"Danbury city, Connecticut",28369,1685,17309,1820,11060,1670
1600000US0937000,0937000,"Hartford city, Connecticut",45659,2286,10214,1294,35445,2163
1600000US0950370,0950370,"New Britain city, Connecticut",27809,1654,10905,1520,16904,1470
1600000US0952000,0952000,"New Haven city, Connecticut",49184,2697,14395,1735,34789,2434
1600000US0955990,0955990,"Norwalk city, Connecticut",38987,1929,23415,2040,15572,1817
1600000US0973000,0973000,"Stamford city, Connecticut",43972,1952,24679,1806,19293,1714
1600000US0980000,0980000,"Waterbury city, Connecticut",42038,1837,20591,1805,21447,1792
1600000US1077580,1077580,"Wilmington city, Delaware",30025,1472,13320,1364,16705,1431
1600000US1150000,1150000,"Washington city, District of Columbia",268670,3200,110625,3425,158045,3930
1600000US1200410,1200410,"Alafaya CDP, Florida",25023,3038,17207,2879,7816,2214
1600000US1207300,1207300,"Boca Raton city, Florida",36172,1888,24423,2021,11749,1768
1600000US1207875,1207875,"Boynton Beach city, Florida",28311,1886,18543,2046,9768,1231
1600000US1208150,1208150,"Brandon CDP, Florida",38751,2959,22167,1880,16584,2547
1600000US1210275,1210275,"Cape Coral city, Florida",55058,3543,39971,3605,15087,2020
1600000US1212875,1212875,"Clearwater city, Florida",47731,2857,29010,2528,18721,2452
1600000US1214400,1214400,"Coral Springs city, Florida",40724,2074,25084,1966,15640,2005
1600000US1216475,1216475,"Davie town, Florida",32925,1779,24087,2148,8838,1485
1600000US1216725,1216725,"Deerfield Beach city, Florida",30338,2221,19575,1978,10763,1450
1600000US1217200,1217200,"Deltona city, Florida",28056,2281,23679,2282,4377,1211
1600000US1224000,1224000,"Fort Lauderdale city, Florida",75189,3549,36454,2782,38735,2911
1600000US1224125,1224125,"Fort Myers city, Florida",22141,1632,10077,1377,12064,1541
1600000US1225175,1225175,"Gainesville city, Florida",49572,2460,16510,1832,33062,2815
1600000US1230000,1230000,"Hialeah city, Florida",68640,2826,34315,2515,34325,2929
1600000US1232000,1232000,"Hollywood city, Florida",53148,2655,31820,2680,21328,2255
1600000US1235000,1235000,"Jacksonville city, Florida",311369,4606,194318,4808,117051,4854
1600000US1236100,1236100,"Kendall CDP, Florida",28644,2394,16921,1549,11723,1796
1600000US1238250,1238250,"Lakeland city, Florida",39678,2478,21828,2125,17850,1684
1600000US1239425,1239425,"Largo city, Florida",34683,2301,19985,1993,14698,1838
1600000US1239550,1239550,"Lauderhill city, Florida",22435,2111,14173,1643,8262,1741
1600000US1239925,1239925,"Lehigh Acres CDP, Florida",30778,2364,18730,2176,12048,1801
1600000US1243975,1243975,"Melbourne city, Florida",31670,2257,19310,2180,12360,1909
1600000US1245000,1245000,"Miami city, Florida",149874,4205,47190,4147,102684,4544
1600000US1245025,1245025,"Miami Beach city, Florida",42727,3597,13654,2436,29073,2797
1600000US1245060,1245060,"Miami Gardens city, Florida",30403,2037,20697,1619,9706,1675
1600000US1245975,1245975,"Miramar city, Florida",41117,2528,30096,2701,11021,2136
1600000US1253000,1253000,"Orlando city, Florida",97918,3378,38479,2709,59439,2755
1600000US1254000,1254000,"Palm Bay city, Florida",34947,2483,26589,2425,8358,1691
1600000US1254200,1254200,"Palm Coast city, Florida",27859,3442,21222,2756,6637,2666
1600000US1255775,1255775,"Pembroke Pines city, Florida",57682,3107,40639,3011,17043,2955
1600000US1257425,1257425,"Plantation city, Florida",31585,2093,21485,1863,10100,1789
1600000US1258050,1258050,"Pompano Beach city, Florida",42420,2438,21941,2268,20479,2113
1600000US1258715,1258715,"Port St. Lucie city, Florida",54766,3282,43290,3289,11476,2509
1600000US1260950,1260950,"Riverview CDP, Florida",21235,2485,16396,1914,4839,1744
1600000US1263000,1263000,"St. Petersburg city, Florida",101235,3611,59201,3057,42034,3155
1600000US1268350,1268350,"Spring Hill CDP, Florida",41335,2515,32770,2191,8565,1572
1600000US1269700,1269700,"Sunrise city, Florida",30382,1884,20492,2018,9890,1630
1600000US1270600,1270600,"Tallahassee city, Florida",73490,2592,30388,2125,43102,2881
1600000US1271000,1271000,"Tampa city, Florida",136664,3755,67619,3157,69045,3407
1600000US1272145,1272145,"Town 'n' Country CDP, Florida",29696,2639,17001,1873,12695,1913
1600000US1276582,1276582,"Weston city, Florida",21286,1309,15444,1759,5842,1613
1600000US1276600,1276600,"West Palm Beach city, Florida",39798,2286,19894,2051,19904,1918
1600000US1301052,1301052,"Albany city, Georgia",29901,1205,12100,1135,17801,1363
1600000US1303440,1303440,"Athens-Clarke County unified government (balance), Georgia",39708,1777,17712,1204,21996,1678
1600000US1304000,1304000,"Atlanta city, Georgia",174922,5559,77500,4429,97422,5095
1600000US1304204,1304204,"Augusta-Richmond County consolidated government (balance), Georgia",69240,2190,37361,2387,31879,2035
1600000US1319000,1319000,"Columbus city, Georgia",70724,1790,36778,1993,33946,2287
1600000US1342425,1342425,"Johns Creek city, Georgia",26387,1995,21286,1875,5101,1864
1600000US1349000,1349000,"Macon city, Georgia",32637,1782,12950,1673,19687,1793
1600000US1367284,1367284,"Roswell city, Georgia",33523,2174,22036,1999,11487,1660
1600000US1368516,1368516,"Sandy Springs city, Georgia",41376,3055,18484,2274,22892,2683
1600000US1369000,1369000,"Savannah city, Georgia",49773,1987,23136,1599,26637,1864
1600000US1380508,1380508,"Warner Robins city, Georgia",26428,1794,15452,1784,10976,1631
1600000US1571550,1571550,"Urban Honolulu CDP, Hawaii",127512,3272,52410,2979,75102,3230
1600000US1608830,1608830,"Boise City city, Idaho",85464,2636,50312,2851,35152,2695
1600000US1652120,1652120,"Meridian city, Idaho",27758,1767,20548,2084,7210,1776
1600000US1656260,1656260,"Nampa city, Idaho",28300,1986,17899,1683,10401,2062
1600000US1702154,1702154,"Arlington Heights village, Illinois",32149,1975,24472,1705,7677,1591
1600000US1703012,1703012,"Aurora city, Illinois",58723,3664,39971,2991,18752,2869
1600000US1706613,1706613,"Bloomington city, Illinois",30164,1380,19138,1426,11026,1454
1600000US1707133,1707133,"Bolingbrook village, Illinois",21448,1816,17741,1658,3707,1279
1600000US1712385,1712385,"Champaign city, Illinois",32280,1917,14885,1505,17395,1692
1600000US1714000,1714000,"Chicago city, Illinois",1016342,8953,449479,8260,566863,9203
1600000US1714351,1714351,"Cicero town, Illinois",21825,1333,11460,1340,10365,1331
1600000US1718823,1718823,"Decatur city, Illinois",29964,1377,17510,1220,12454,1335
1600000US1723074,1723074,"Elgin city, Illinois",35188,2933,24691,2543,10497,2111
1600000US1724582,1724582,"Evanston city, Illinois",31866,1935,17432,1610,14434,1877
1600000US1738570,1738570,"Joliet city, Illinois",47609,2540,34704,2265,12905,1708
1600000US1751622,1751622,"Naperville city, Illinois",47768,1854,37766,1992,10002,1426
1600000US1757225,1757225,"Palatine village, Illinois",24917,1753,16633,1601,8284,1398
1600000US1759000,1759000,"Peoria city, Illinois",46485,1785,25311,1735,21174,1784
1600000US1765000,1765000,"Rockford city, Illinois",58270,1987,32832,1668,25438,1703
1600000US1768003,1768003,"Schaumburg village, Illinois",29274,1989,19383,1740,9891,1613
1600000US1770122,1770122,"Skokie village, Illinois",23841,1669,17037,1894,6804,1454
1600000US1772000,1772000,"Springfield city, Illinois",51468,1714,31880,1557,19588,1712
1600000US1779293,1779293,"Waukegan city, Illinois",27980,1736,15922,1181,12058,1787
1600000US1805860,1805860,"Bloomington city, Indiana",30404,1962,9658,1142,20746,1969
1600000US1810342,1810342,"Carmel city, Indiana",28488,1761,23231,1792,5257,1305
1600000US1822000,1822000,"Evansville city, Indiana",50843,1908,28667,1867,22176,1829
1600000US1823278,1823278,"Fishers town, Indiana",26557,1907,23196,1978,3361,1251
1600000US1825000,1825000,"Fort Wayne city, Indiana",101313,2133,64270,2380,37043,2100
1600000US1827000,1827000,"Gary city, Indiana",30362,1624,15772,1507,14590,1305
1600000US1831000,1831000,"Hammond city, Indiana",27714,1440,18631,1314,9083,1217
1600000US1836003,1836003,"Indianapolis city (balance), Indiana",324438,4766,177603,4067,146835,5439
1600000US1840788,1840788,"Lafayette city, Indiana",27479,1506,13597,1122,13882,1548
1600000US1851876,1851876,"Muncie city, Indiana",26746,1717,13655,1097,13091,1548
1600000US1871000,1871000,"South Bend city, Indiana",40552,1907,24355,1454,16197,1422
1600000US1912000,1912000,"Cedar Rapids city, Iowa",52909,1864,37479,1647,15430,1525
1600000US1919000,1919000,"Davenport city, Iowa",40379,1341,23560,1449,16819,1565
1600000US1921000,1921000,"Des Moines city, Iowa",80140,2177,50068,2768,30072,2304
1600000US1938595,1938595,"Iowa City city, Iowa",27147,1645,13290,1077,13857,1602
1600000US1973335,1973335,"Sioux City city, Iowa",31489,1051,19419,1290,12070,1482
1600000US1982425,1982425,"Waterloo city, Iowa",27435,1138,17440,1303,9995,1176
1600000US2036000,2036000,"Kansas City city, Kansas",52494,1417,31935,1530,20559,1384
1600000US2038900,2038900,"Lawrence city, Kansas",34960,1544,15594,1420,19366,1565
1600000US2052575,2052575,"Olathe city, Kansas",46194,1898,33749,1807,12445,1540
1600000US2053775,2053775,"Overland Park city, Kansas",69617,2153,47269,2158,22348,2072
1600000US2071000,2071000,"Topeka city, Kansas",52869,1593,30783,1932,22086,1816
1600000US2079000,2079000,"Wichita city, Kansas",149045,2737,90923,2618,58122,2642
1600000US2146027,2146027,"Lexington-Fayette urban county, Kentucky",122746,2283,70899,2474,51847,2683
1600000US2148006,2148006,"Louisville/Jefferson County metro government (balance), Kentucky",238403,3828,148241,3841,90162,3977
1600000US2205000,2205000,"Baton Rouge city, Louisiana",88879,2687,45429,2463,43450,2657
1600000US2239475,2239475,"Kenner city, Louisiana",24892,1434,14603,1674,10289,1356
1600000US2240735,2240735,"Lafayette city, Louisiana",50959,2259,28377,2144,22582,2521
1600000US2241155,2241155,"Lake Charles city, Louisiana",28717,1763,15673,1390,13044,1301
1600000US2250115,2250115,"Metairie CDP, Louisiana",57742,2523,34555,1884,23187,2286
1600000US2255000,2255000,"New Orleans city, Louisiana",147786,2745,67090,2150,80696,2627
1600000US2270000,2270000,"Shreveport city, Louisiana",78209,2035,44167,1977,34042,2320
1600000US2360545,2360545,"Portland city, Maine",30576,1545,13016,1352,17560,1574
1600000US2404000,2404000,"Baltimore city, Maryland",239251,4011,116312,3638,122939,3618
1600000US2419125,2419125,"Columbia CDP, Maryland",41172,1939,26715,1713,14457,1771
1600000US2426000,2426000,"Ellicott City CDP, Maryland",24553,1666,18946,1405,5607,1280
1600000US2430325,2430325,"Frederick city, Maryland",25507,1708,14107,1927,11400,1445
1600000US2432025,2432025,"Germantown CDP, Maryland",31097,2580,20221,2216,10876,2018
1600000US2432650,2432650,"Glen Burnie CDP, Maryland",26580,1824,16825,1468,9755,1814
1600000US2472450,2472450,"Silver Spring CDP, Maryland",30994,1978,11276,996,19718,1809
1600000US2481175,2481175,"Waldorf CDP, Maryland",24757,1539,16296,1638,8461,1710
1600000US2507000,2507000,"Boston city, Massachusetts",251745,3435,84440,3560,167305,4113
1600000US2509000,2509000,"Brockton city, Massachusetts",33720,1524,18446,1398,15274,1543
1600000US2511000,2511000,"Cambridge city, Massachusetts",44804,1831,16102,1541,28702,1856
1600000US2523000,2523000,"Fall River city, Massachusetts",38126,1978,13634,1628,24492,2230
1600000US2524960,2524960,"Framingham CDP, Massachusetts",26188,1789,14770,1224,11418,1646
1600000US2534550,2534550,"Lawrence city, Massachusetts",28433,1156,8487,1248,19946,1212
1600000US2537000,2537000,"Lowell city, Massachusetts",38359,2026,18281,1614,20078,1894
1600000US2537490,2537490,"Lynn city, Massachusetts",33831,1513,16748,1451,17083,1452
1600000US2545000,2545000,"New Bedford city, Massachusetts",38670,1515,16523,1555,22147,1612
1600000US2545560,2545560,"Newton city, Massachusetts",31852,1603,20831,1558,11021,1444
1600000US2555745,2555745,"Quincy city, Massachusetts",38730,2009,18928,1990,19802,2052
1600000US2562535,2562535,"Somerville city, Massachusetts",32108,1929,10561,1439,21547,1756
1600000US2567000,2567000,"Springfield city, Massachusetts",55857,2338,26585,2152,29272,2292
1600000US2582000,2582000,"Worcester city, Massachusetts",68687,2301,30483,1885,38204,2292
1600000US2603000,2603000,"Ann Arbor city, Michigan",48275,1784,21580,1426,26695,1754
1600000US2621000,2621000,"Dearborn city, Michigan",31011,1615,21615,1454,9396,1185
1600000US2622000,2622000,"Detroit city, Michigan",253629,5276,131300,4025,122329,4081
1600000US2627440,2627440,"Farmington Hills city, Michigan",32530,1494,21363,1445,11167,1335
1600000US2629000,2629000,"Flint city, Michigan",39875,1720,22296,1555,17579,1742
1600000US2634000,2634000,"Grand Rapids city, Michigan",73222,2552,39628,2308,33594,2327
1600000US2642160,2642160,"Kalamazoo city, Michigan",27145,1541,11687,1101,15458,1467
1600000US2646000,2646000,"Lansing city, Michigan",47922,1797,24088,1653,23834,1919
1600000US2649000,2649000,"Livonia city, Michigan",38260,1545,32851,1551,5409,867
1600000US2669035,2669035,"Rochester Hills city, Michigan",27757,1323,21006,1292,6751,1016
1600000US2674900,2674900,"Southfield city, Michigan",31936,1776,14986,1417,16950,1441
1600000US2676460,2676460,"Sterling Heights city, Michigan",50469,2328,37524,2155,12945,1594
1600000US2680700,2680700,"Troy city, Michigan",29867,1209,21444,1337,8423,1099
1600000US2684000,2684000,"Warren city, Michigan",54998,1881,41174,2076,13824,1475
1600000US2686000,2686000,"Westland city, Michigan",33275,1521,19959,1607,13316,1277
1600000US2688940,2688940,"Wyoming city, Michigan",25585,1457,16662,1320,8923,1374
1600000US2706616,2706616,"Bloomington city, Minnesota",36374,1519,25615,1352,10759,1162
1600000US2707966,2707966,"Brooklyn Park city, Minnesota",25526,1573,18236,1364,7290,1077
1600000US2717000,2717000,"Duluth city, Minnesota",33626,1628,20375,1366,13251,1285
1600000US2743000,2743000,"Minneapolis city, Minnesota",165562,3131,81878,2874,83684,3249
1600000US2751730,2751730,"Plymouth city, Minnesota",28580,1468,19715,1340,8865,1458
1600000US2754880,2754880,"Rochester city, Minnesota",43428,1211,30308,1470,13120,1466
1600000US2756896,2756896,"St. Cloud city, Minnesota",25985,1611,13439,1235,12546,1509
1600000US2758000,2758000,"St. Paul city, Minnesota",113034,2737,54366,2444,58668,2617
1600000US2829700,2829700,"Gulfport city, Mississippi",26494,1641,14811,1763,11683,1462
1600000US2836000,2836000,"Jackson city, Mississippi",60928,2019,32039,2078,28889,2352
1600000US2915670,2915670,"Columbia city, Missouri",41449,1500,18734,1380,22715,1832
1600000US2935000,2935000,"Independence city, Missouri",48289,2282,32295,1816,15994,1862
1600000US2938000,2938000,"Kansas City city, Missouri",191967,3739,107446,3414,84521,3461
1600000US2941348,2941348,"Lee's Summit city, Missouri",31961,1747,23188,1865,8773,1502
1600000US2954074,2954074,"O'Fallon city, Missouri",26921,1459,21342,1798,5579,1324
1600000US2964082,2964082,"St. Charles city, Missouri",26292,1447,17032,1409,9260,1437
1600000US2964550,2964550,"St. Joseph city, Missouri",27668,1299,16679,1163,10989,1252
1600000US2965000,2965000,"St. Louis city, Missouri",134193,3142,59720,2375,74473,3518
1600000US2970000,2970000,"Springfield city, Missouri",70986,2019,32876,1959,38110,2139
1600000US3006550,3006550,"Billings city, Montana",43347,1486,27632,1692,15715,1832
1600000US3050200,3050200,"Missoula city, Montana",28743,1255,13840,1444,14903,1440
1600000US3128000,3128000,"Lincoln city, Nebraska",104577,1891,60105,2168,44472,2137
1600000US3137000,3137000,"Omaha city, Nebraska",163314,2906,94941,2995,68373,2938
1600000US3223770,3223770,"Enterprise CDP, Nevada",41269,4844,24219,3686,17050,3497
1600000US3231900,3231900,"Henderson city, Nevada",98019,4166,62304,4371,35715,2926
1600000US3240000,3240000,"Las Vegas city, Nevada",208279,5625,107990,4940,100289,4863
1600000US3251800,3251800,"North Las Vegas city, Nevada",67222,3369,38832,3174,28390,3113
1600000US3254600,3254600,"Paradise CDP, Nevada",86939,4037,35420,2937,51519,3756
1600000US3260600,3260600,"Reno city, Nevada",89362,3059,42530,2538,46832,3279
1600000US3268400,3268400,"Sparks city, Nevada",33585,1911,19733,1949,13852,1614
1600000US3268585,3268585,"Spring Valley CDP, Nevada",69344,4812,31885,3037,37459,4137
1600000US3271400,3271400,"Sunrise Manor CDP, Nevada",56888,2854,28595,2225,28293,2513
1600000US3345140,3345140,"Manchester city, New Hampshire",44989,1611,21472,1746,23517,1729
1600000US3350260,3350260,"Nashua city, New Hampshire",34082,1463,19316,1554,14766,1622
1600000US3410000,3410000,"Camden city, New Jersey",25112,1622,9942,1311,15170,1358
1600000US3413690,3413690,"Clifton city, New Jersey",28619,1792,17726,1620,10893,1451
1600000US3419390,3419390,"East Orange city, New Jersey",26544,1714,6393,1177,20151,1778
1600000US3421000,3421000,"Elizabeth city, New Jersey",38278,1737,10234,1326,28044,1825
1600000US3436000,3436000,"Jersey City city, New Jersey",96601,2559,29626,2258,66975,2901
1600000US3451000,3451000,"Newark city, New Jersey",88467,2632,18450,1637,70017,2690
1600000US3456550,3456550,"Passaic city, New Jersey",22692,2161,5942,1422,16750,2439
1600000US3457000,3457000,"Paterson city, New Jersey",43038,1726,10818,1359,32220,1854
1600000US3473110,3473110,"Toms River CDP, New Jersey",32908,1758,26346,1785,6562,1349
1600000US3474000,3474000,"Trenton city, New Jersey",28536,1719,11446,1485,17090,1701
1600000US3474630,3474630,"Union City city, New Jersey",22052,1492,3787,815,18265,1425
1600000US3502000,3502000,"Albuquerque city, New Mexico",224445,3554,131724,3787,92721,4408
1600000US3539380,3539380,"Las Cruces city, New Mexico",38883,1805,22501,2005,16382,1816
1600000US3563460,3563460,"Rio Rancho city, New Mexico",32967,1356,24861,1947,8106,1656
1600000US3570500,3570500,"Santa Fe city, New Mexico",30493,1721,17093,1534,13400,1412
1600000US3601000,3601000,"Albany city, New York",38251,1877,15123,1421,23128,1985
1600000US3611000,3611000,"Buffalo city, New York",111424,3099,45052,2555,66372,2866
1600000US3615000,3615000,"Cheektowaga CDP, New York",33032,1480,23004,1572,10028,1274
1600000US3649121,3649121,"Mount Vernon city, New York",25520,1394,9314,968,16206,1539
1600000US3650617,3650617,"New Rochelle city, New York",29114,1349,14843,1339,14271,1287
1600000US3651000,3651000,"New York city, New York",3023330,11705,946765,11082,2076565,15598
1600000US3663000,3663000,"Rochester city, New York",85939,2772,32384,2538,53555,2729
1600000US3665508,3665508,"Schenectady city, New York",24378,1403,10336,1077,14042,1252
1600000US3673000,3673000,"Syracuse city, New York",54801,2078,21845,1691,32956,2062
1600000US3684000,3684000,"Yonkers city, New York",74094,2695,32693,2488,41401,2848
1600000US3702140,3702140,"Asheville city, North Carolina",37481,1888,18517,1637,18964,1682
1600000US3710740,3710740,"Cary town, North Carolina",48639,2726,34259,2522,14380,2316
1600000US3712000,3712000,"Charlotte city, North Carolina",292715,4233,165604,5705,127111,6014
1600000US3714100,3714100,"Concord city, North Carolina",29351,2131,19352,2155,9999,1807
1600000US3719000,3719000,"Durham city, North Carolina",95430,2550,46360,2734,49070,2522
1600000US3722920,3722920,"Fayetteville city, North Carolina",76787,2364,39460,2618,37327,2524
1600000US3725580,3725580,"Gastonia city, North Carolina",26374,1546,13954,1144,12420,1493
1600000US3728000,3728000,"Greensboro city, North Carolina",113127,3356,63967,3261,49160,2941
1600000US3728080,3728080,"Greenville city, North Carolina",32771,1927,11793,2021,20978,2213
1600000US3731400,3731400,"High Point city, North Carolina",40777,1975,23095,1886,17682,1975
1600000US3734200,3734200,"Jacksonville city, North Carolina",19596,1431,8539,1333,11057,1554
1600000US3755000,3755000,"Raleigh city, North Carolina",159961,4836,88060,4599,71901,4864
1600000US3774440,3774440,"Wilmington city, North Carolina",47729,2078,20208,1847,27521,2191
1600000US3775000,3775000,"Winston-Salem city, North Carolina",91339,2714,52452,2347,38887,2258
1600000US3825700,3825700,"Fargo city, North Dakota",47606,1774,21759,1630,25847,2031
1600000US3901000,3901000,"Akron city, Ohio",80445,2650,43696,2252,36749,2419
1600000US3912000,3912000,"Canton city, Ohio",28700,1744,14328,1669,14372,1518
1600000US3915000,3915000,"Cincinnati city, Ohio",125928,3234,53150,2642,72778,3091
1600000US3916000,3916000,"Cleveland city, Ohio",171000,3332,76728,3119,94272,3360
1600000US3918000,3918000,"Columbus city, Ohio",322314,4852,146208,4129,176106,5024
1600000US3921000,3921000,"Dayton city, Ohio",57850,2261,26401,1898,31449,2045
1600000US3944856,3944856,"Lorain city, Ohio",26136,1388,15777,1444,10359,1277
1600000US3961000,3961000,"Parma city, Ohio",32048,1309,22564,1461,9484,1076
1600000US3977000,3977000,"Toledo city, Ohio",116635,2775,61962,2693,54673,2721
1600000US3988000,3988000,"Youngstown city, Ohio",26926,1531,15398,1170,11528,1240
1600000US4009050,4009050,"Broken Arrow city, Oklahoma",37133,1265,29463,1489,7670,1071
1600000US4023200,4023200,"Edmond city, Oklahoma",31556,1562,22450,1576,9106,1436
1600000US4041850,4041850,"Lawton city, Oklahoma",34760,1387,17013,1507,17747,1525
1600000US4052500,4052500,"Norman city, Oklahoma",43173,1787,25332,1937,17841,1770
1600000US4055000,4055000,"Oklahoma City city, Oklahoma",225089,4147,130866,3756,94223,4064
1600000US4075000,4075000,"Tulsa city, Oklahoma",163222,3107,89471,2736,73751,2679
1600000US4105350,4105350,"Beaverton city, Oregon",34082,1827,17237,1591,16845,1844
1600000US4105800,4105800,"Bend city, Oregon",33939,1918,17833,1841,16106,2128
1600000US4123850,4123850,"Eugene city, Oregon",66126,2129,29651,2171,36475,2507
1600000US4131250,4131250,"Gresham city, Oregon",40116,2191,21581,1615,18535,1913
1600000US4134100,4134100,"Hillsboro city, Oregon",34645,2070,18529,2091,16116,2119
1600000US4147000,4147000,"Medford city, Oregon",30783,1849,13534,1826,17249,1723
1600000US4159000,4159000,"Portland city, Oregon",250828,2699,128055,3684,122773,3945
1600000US4164900,4164900,"Salem city, Oregon",57196,1994,30146,2229,27050,2182
1600000US4202000,4202000,"Allentown city, Pennsylvania",42279,2149,18930,1994,23349,1777
1600000US4206088,4206088,"Bethlehem city, Pennsylvania",29545,1810,15883,1648,13662,1438
1600000US4224000,4224000,"Erie city, Pennsylvania",40989,1444,21877,1395,19112,1467
1600000US4260000,4260000,"Philadelphia city, Pennsylvania",576429,4899,311303,7659,265126,7665
1600000US4261000,4261000,"Pittsburgh city, Pennsylvania",131776,2904,63514,2493,68262,2717
1600000US4263624,4263624,"Reading city, Pennsylvania",31916,1307,14315,1290,17601,1476
1600000US4269000,4269000,"Scranton city, Pennsylvania",29545,1501,15438,1206,14107,1355
1600000US4419180,4419180,"Cranston city, Rhode Island",29490,1856,18594,1543,10896,1510
1600000US4454640,4454640,"Pawtucket city, Rhode Island",29861,1422,13228,1357,16633,1589
1600000US4459000,4459000,"Providence city, Rhode Island",63284,2505,22595,2156,40689,2430
1600000US4474300,4474300,"Warwick city, Rhode Island",34245,1534,25070,1640,9175,1512
1600000US4513330,4513330,"Charleston city, South Carolina",50420,2491,26901,2461,23519,2408
1600000US4516000,4516000,"Columbia city, South Carolina",43908,2190,21763,1924,22145,1601
1600000US4548535,4548535,"Mount Pleasant town, South Carolina",27373,2223,20947,2494,6426,1457
1600000US4550875,4550875,"North Charleston city, South Carolina",35655,2268,17953,2146,17702,1907
1600000US4561405,4561405,"Rock Hill city, South Carolina",27689,1494,14243,1651,13446,1896
1600000US4652980,4652980,"Rapid City city, South Dakota",26550,1658,15179,1288,11371,1344
1600000US4659020,4659020,"Sioux Falls city, South Dakota",63473,2125,38592,2191,24881,2534
1600000US4714000,4714000,"Chattanooga city, Tennessee",69351,2511,36025,2577,33326,2371
1600000US4715160,4715160,"Clarksville city, Tennessee",50991,1873,26494,2552,24497,2627
1600000US4737640,4737640,"Jackson city, Tennessee",22730,1179,14048,1268,8682,1214
1600000US4740000,4740000,"Knoxville city, Tennessee",82487,2930,40331,2523,42156,2509
1600000US4748000,4748000,"Memphis city, Tennessee",245836,4445,121164,4216,124672,4416
1600000US4751560,4751560,"Murfreesboro city, Tennessee",43483,2288,24903,2579,18580,2350
1600000US4752006,4752006,"Nashville-Davidson metropolitan government (balance), Tennessee",244365,3493,130303,3829,114062,4106
1600000US4801000,4801000,"Abilene city, Texas",41886,1747,25491,1788,16395,1689
1600000US4801924,4801924,"Allen city, Texas",30560,2288,24624,2250,5936,1678
1600000US4803000,4803000,"Amarillo city, Texas",74756,1667,46348,1770,28408,1771
1600000US4804000,4804000,"Arlington city, Texas",130544,3740,75767,3253,54777,3735
1600000US4804462,4804462,"Atascocita CDP, Texas",22252,2416,17321,2230,4931,1665
1600000US4805000,4805000,"Austin city, Texas",331582,5920,141585,5060,189997,5462
1600000US4806128,4806128,"Baytown city, Texas",23110,1481,13465,1392,9645,1253
1600000US4807000,4807000,"Beaumont city, Texas",46367,1995,27663,1712,18704,2036
1600000US4810768,4810768,"Brownsville city, Texas",51437,1961,32539,1701,18898,1620
1600000US4810912,4810912,"Bryan city, Texas",27862,1661,13707,1780,14155,1398
1600000US4813024,4813024,"Carrollton city, Texas",42397,1947,25240,2322,17157,2240
1600000US4815976,4815976,"College Station city, Texas",31743,2099,9459,1290,22284,2116
1600000US4817000,4817000,"Corpus Christi city, Texas",110554,2448,61404,3068,49150,3096
1600000US4819000,4819000,"Dallas city, Texas",455371,6913,198413,5647,256958,6924
1600000US4819972,4819972,"Denton city, Texas",40704,2841,18478,2024,22226,2657
1600000US4822660,4822660,"Edinburg city, Texas",21149,1674,11102,1476,10047,1655
1600000US4824000,4824000,"El Paso city, Texas",219568,3630,128068,4429,91500,4687
1600000US4826232,4826232,"Flower Mound town, Texas",20887,1594,18970,1613,1917,1047
1600000US4827000,4827000,"Fort Worth city, Texas",263676,5998,153791,5311,109885,4697
1600000US4827684,4827684,"Frisco city, Texas",39067,1815,29414,2488,9653,2341
1600000US4829000,4829000,"Garland city, Texas",70798,3110,45577,3116,25221,2125
1600000US4830464,4830464,"Grand Prairie city, Texas",58952,2720,33937,2528,25015,2512
1600000US4832372,4832372,"Harlingen city, Texas",19372,1156,10508,1320,8864,1171
1600000US4835000,4835000,"Houston city, Texas",774630,7511,348919,7756,425711,7830
1600000US4837000,4837000,"Irving city, Texas",82813,3476,33448,2299,49365,3354
1600000US4839148,4839148,"Killeen city, Texas",42852,2423,19150,2428,23702,2769
1600000US4841464,4841464,"Laredo city, Texas",64277,1624,39061,2416,25216,2214
1600000US4841980,4841980,"League City city, Texas",28334,1643,21658,1930,6676,1542
1600000US4842508,4842508,"Lewisville city, Texas",39310,3274,17555,2017,21755,3117
1600000US4843888,4843888,"Longview city, Texas",31165,1381,17067,1625,14098,1605
1600000US4845000,4845000,"Lubbock city, Texas",87311,2543,47249,2536,40062,2933
1600000US4845384,4845384,"McAllen city, Texas",43459,2273,25696,1958,17763,2198
1600000US4845744,4845744,"McKinney city, Texas",43609,2521,29052,2657,14557,2833
1600000US4847892,4847892,"Mesquite city, Texas",49594,2525,29157,2103,20437,1979
1600000US4848072,4848072,"Midland city, Texas",40734,1474,26513,1557,14221,1434
1600000US4848768,4848768,"Mission city, Texas",21927,2649,17077,2202,4850,1475
1600000US4848804,4848804,"Missouri City city, Texas",22219,1976,19647,2274,2572,1138
1600000US4852356,4852356,"North Richland Hills city, Texas",22960,1500,14866,1559,8094,1321
1600000US4853388,4853388,"Odessa city, Texas",38178,1301,23251,1614,14927,1784
1600000US4856000,4856000,"Pasadena city, Texas",47729,2245,26092,1696,21637,1868
1600000US4856348,4856348,"Pearland city, Texas",33632,1800,28475,1637,5157,1402
1600000US4857200,4857200,"Pharr city, Texas",19866,1820,12587,1561,7279,1804
1600000US4858016,4858016,"Plano city, Texas",102893,3523,63917,3115,38976,3258
1600000US4861796,4861796,"Richardson city, Texas",37444,1806,22538,1863,14906,1448
1600000US4863500,4863500,"Round Rock city, Texas",36809,2762,21680,2006,15129,2661
1600000US4864472,4864472,"San Angelo city, Texas",35258,1584,20974,1661,14284,1659
1600000US4865000,4865000,"San Antonio city, Texas",482783,6226,266021,6183,216762,7105
1600000US4870808,4870808,"Sugar Land city, Texas",27425,1442,22241,1438,5184,1296
1600000US4872176,4872176,"Temple city, Texas",24409,1479,14554,1490,9855,1382
1600000US4872656,4872656,"The Woodlands CDP, Texas",38805,2931,27410,2696,11395,2118
1600000US4874144,4874144,"Tyler city, Texas",38680,2005,20158,1972,18522,2099
1600000US4876000,4876000,"Waco city, Texas",45318,1808,20878,1610,24440,1976
1600000US4879000,4879000,"Wichita Falls city, Texas",35955,1675,22090,1598,13865,1532
1600000US4943660,4943660,"Layton city, Utah",22358,1339,17792,1261,4566,1021
1600000US4955980,4955980,"Ogden city, Utah",29903,1491,16652,1413,13251,1521
1600000US4957300,4957300,"Orem city, Utah",25662,1353,15654,1314,10008,1221
1600000US4962470,4962470,"Provo city, Utah",32284,1460,12570,1413,19714,1585
1600000US4965330,4965330,"St. George city, Utah",23841,2250,15746,1607,8095,1547
1600000US4967000,4967000,"Salt Lake City city, Utah",74088,2874,34698,2319,39390,2174
1600000US4967440,4967440,"Sandy city, Utah",29097,1404,23195,1347,5902,979
1600000US4982950,4982950,"West Jordan city, Utah",30470,1734,23187,1635,7283,1351
1600000US4983470,4983470,"West Valley City city, Utah",38432,2082,24966,1952,13466,1571
1600000US5101000,5101000,"Alexandria city, Virginia",64723,2105,28207,2154,36516,2618
1600000US5103000,5103000,"Arlington CDP, Virginia",91386,3535,41999,2486,49387,3312
1600000US5114440,5114440,"Centreville CDP, Virginia",25066,2470,16831,2118,8235,1958
1600000US5116000,5116000,"Chesapeake city, Virginia",78004,1928,56849,2533,21155,2137
1600000US5121088,5121088,"Dale City CDP, Virginia",19760,1806,13852,1713,5908,1621
1600000US5135000,5135000,"Hampton city, Virginia",51006,2026,33761,1875,17245,1814
1600000US5147672,5147672,"Lynchburg city, Virginia",29648,1213,15952,1305,13696,1409
1600000US5156000,5156000,"Newport News city, Virginia",66533,2424,34953,2210,31580,2564
1600000US5157000,5157000,"Norfolk city, Virginia",86480,2758,39969,1553,46511,2522
1600000US5164000,5164000,"Portsmouth city, Virginia",36207,1115,21219,1626,14988,1538
1600000US5167000,5167000,"Richmond city, Virginia",84355,2003,38022,1721,46333,2516
1600000US5168000,5168000,"Roanoke city, Virginia",41267,1464,23720,1409,17547,1772
1600000US5176432,5176432,"Suffolk city, Virginia",30199,1129,22069,1378,8130,1328
1600000US5182000,5182000,"Virginia Beach city, Virginia",162521,2517,105566,2771,56955,3070
1600000US5303180,5303180,"Auburn city, Washington",28641,1862,16854,1629,11787,1871
1600000US5305210,5305210,"Bellevue city, Washington",50119,1986,27285,2255,22834,2171
1600000US5305280,5305280,"Bellingham city, Washington",34569,2064,17213,1988,17356,2267
1600000US5322640,5322640,"Everett city, Washington",42150,2156,17744,1674,24406,2072
1600000US5323515,5323515,"Federal Way city, Washington",33917,1712,18882,1804,15035,1595
1600000US5335275,5335275,"Kennewick city, Washington",25596,1898,15496,1843,10100,1561
1600000US5335415,5335415,"Kent city, Washington",40716,1732,20492,1847,20224,1595
1600000US5357745,5357745,"Renton city, Washington",37075,2520,20465,2145,16610,2059
1600000US5363000,5363000,"Seattle city, Washington",282492,4134,129326,4809,153166,4285
1600000US5367000,5367000,"Spokane city, Washington",89725,2715,52059,2274,37666,2556
1600000US5367167,5367167,"Spokane Valley city, Washington",35266,1653,21578,1776,13688,1509
1600000US5370000,5370000,"Tacoma city, Washington",77149,2915,41093,2290,36056,2582
1600000US5374060,5374060,"Vancouver city, Washington",67976,2086,35668,2579,32308,2356
1600000US5380010,5380010,"Yakima city, Washington",33967,1497,17233,1699,16734,1641
1600000US5502375,5502375,"Appleton city, Wisconsin",29028,1437,20263,1451,8765,1365
1600000US5522300,5522300,"Eau Claire city, Wisconsin",26933,1027,15611,1001,11322,1193
1600000US5531000,5531000,"Green Bay city, Wisconsin",42993,1882,26169,1918,16824,1631
1600000US5539225,5539225,"Kenosha city, Wisconsin",36890,1783,22159,1714,14731,1783
1600000US5548000,5548000,"Madison city, Wisconsin",99839,2912,49086,2695,50753,2859
1600000US5553000,5553000,"Milwaukee city, Wisconsin",229927,3234,98506,3171,131421,4144
1600000US5560500,5560500,"Oshkosh city, Wisconsin",24799,1430,13204,1225,11595,1365
1600000US5566000,5566000,"Racine city, Wisconsin",30993,1625,16011,1543,14982,1337
1600000US5584250,5584250,"Waukesha city, Wisconsin",26857,1529,16337,1336,10520,1452
