GEO.id,GEO.id2,GEO.display-label,HD01_VD01,HD02_VD01,HD01_VD02,HD02_VD02,HD01_VD03,HD02_VD03
1600000US0107000,0107000,"Birmingham city, Alabama",90117,3280,41404,2443,48713,2536
1600000US0121184,0121184,"Dothan city, Alabama",26119,1073,15129,770,10990,774
1600000US0135896,0135896,"Hoover city, Alabama",32110,1725,21807,1581,10303,1182
1600000US0137000,0137000,"Huntsville city, Alabama",80540,2701,45705,2620,34835,2336
1600000US0150000,0150000,"Mobile city, Alabama",79188,2424,42503,2491,36685,2498
1600000US0151000,0151000,"Montgomery city, Alabama",80899,1817,45078,2533,35821,2772
1600000US0177256,0177256,"Tuscaloosa city, Alabama",36313,1884,16456,1531,19857,1839
1600000US0203000,0203000,"Anchorage municipality, Alaska",105249,1864,64320,2628,40929,3066
1600000US0404720,0404720,"Avondale city, Arizona",25849,1421,14109,1523,11740,1335
1600000US0410670,0410670,"Casas Adobes CDP, Arizona",29473,1765,19395,1533,10078,1590
1600000US0412000,0412000,"Chandler city, Arizona",90570,2729,54962,2821,35608,2516
1600000US0423620,0423620,"Flagstaff city, Arizona",22839,1602,11474,1247,11365,1371
1600000US0427400,0427400,"Gilbert town, Arizona",74275,2011,51264,2555,23011,2397
1600000US0427820,0427820,"Glendale city, Arizona",85557,2786,46288,2597,39269,2005
1600000US0428380,0428380,"Goodyear city, Arizona",24232,1884,17764,1822,6468,1302
1600000US0446000,0446000,"Mesa city, Arizona",173852,4538,103159,3917,70693,3305
1600000US0454050,0454050,"Peoria city, Arizona",58106,2220,41132,1872,16974,1739
1600000US0455000,0455000,"Phoenix city, Arizona",555953,7109,294909,6473,261044,6714
1600000US0464210,0464210,"San Tan Valley CDP, Arizona",25182,1869,20086,1978,5096,1241
1600000US0465000,0465000,"Scottsdale city, Arizona",112795,3371,73739,2875,39056,2981
1600000US0471510,0471510,"Surprise city, Arizona",46771,2020,36367,1938,10404,1516
1600000US0473000,0473000,"Tempe city, Arizona",71710,3291,30576,2588,41134,2960
1600000US0477000,0477000,"Tucson city, Arizona",207065,3721,104554,3550,102511,3779
1600000US0485540,0485540,"Yuma city, Arizona",34416,1718,20794,1586,13622,1721
1600000US0515190,0515190,"Conway city, Arkansas",23305,1417,11481,980,11824,1269
1600000US0523290,0523290,"Fayetteville city, Arkansas",33903,1715,11745,1487,22158,1620
1600000US0524550,0524550,"Fort Smith city, Arkansas",36368,1481,18476,1597,17892,2070
1600000US0535710,0535710,"Jonesboro city, Arkansas",29449,1317,15031,1623,14418,1673
1600000US0541000,0541000,"Little Rock city, Arkansas",83957,2639,45056,2612,38901,2882
1600000US0550450,0550450,"North Little Rock city, Arkansas",28691,1962,12154,1710,16537,1644
1600000US0560410,0560410,"Rogers city, Arkansas",23576,1526,14624,1590,8952,1210
1600000US0566080,0566080,"Springdale city, Arkansas",29019,1470,13569,1687,15450,1715
1600000US0600562,0600562,"Alameda city, California",30338,1338,15611,1439,14727,1197
1600000US0600884,0600884,"Alhambra city, California",27960,1592,11080,1225,16880,1719
1600000US0602000,0602000,"Anaheim city, California",99255,3419,41228,2904,58027,2877
1600000US0602252,0602252,"Antioch city, California",34163,1907,21027,2218,13136,1447
1600000US0602364,0602364,"Apple Valley town, California",24012,1640,14109,1590,9903,1169
1600000US0602553,0602553,"Arden-Arcade CDP, California",42909,2648,18701,1420,24208,2467
1600000US0603526,0603526,"Bakersfield city, California",116507,2950,66709,3788,49798,3292
1600000US0603666,0603666,"Baldwin Park city, California",16714,1085,9767,1040,6947,950
1600000US0604982,0604982,"Bellflower city, California",23038,1122,8962,1032,14076,1296
1600000US0606000,0606000,"Berkeley city, California",46078,2150,19127,1439,26951,1990
1600000US0608786,0608786,"Buena Park city, California",23555,1612,13288,1502,10267,1335
1600000US0608954,0608954,"Burbank city, California",40724,2166,16858,1590,23866,2139
1600000US0610046,0610046,"Camarillo city, California",23168,1475,14639,1579,8529,1154
1600000US0611194,0611194,"Carlsbad city, California",41640,1822,27480,1741,14160,1669
1600000US0611390,0611390,"Carmichael CDP, California",25154,1890,13068,1285,12086,1666
1600000US0611530,0611530,"Carson city, California",25790,1380,19034,1606,6756,1015
1600000US0611964,0611964,"Castro Valley CDP, California",24034,1332,15644,1394,8390,1401
1600000US0613014,0613014,"Chico city, California",34985,1597,15089,1638,19896,2015
1600000US0613210,0613210,"Chino city, California",20149,1353,11610,1405,8539,1088
1600000US0613214,0613214,"Chino Hills city, California",24026,1166,18704,1435,5322,1071
1600000US0613392,0613392,"Chula Vista city, California",79639,3233,44929,2896,34710,2527
1600000US0613588,0613588,"Citrus Heights city, California",34269,1634,19714,1691,14555,1705
1600000US0614218,0614218,"Clovis city, California",35979,1775,21279,1653,14700,1345
1600000US0615044,0615044,"Compton city, California",22458,1205,11982,1258,10476,1045
1600000US0616000,0616000,"Concord city, California",45848,2026,25601,2191,20247,1728
1600000US0616350,0616350,"Corona city, California",50765,2089,32411,2014,18354,2053
1600000US0616532,0616532,"Costa Mesa city, California",38127,1877,14023,1524,24104,1607
1600000US0617918,0617918,"Daly City city, California",32969,1549,18472,1493,14497,1622
1600000US0618100,0618100,"Davis city, California",23542,1199,10319,1184,13223,1058
1600000US0619766,0619766,"Downey city, California",32646,1610,14820,1361,17826,1516
1600000US0620802,0620802,"East Los Angeles CDP, California",33058,1989,10498,1278,22560,1664
1600000US0621712,0621712,"El Cajon city, California",32447,1739,12443,1492,20004,1667
1600000US0622020,0622020,"Elk Grove city, California",51695,1918,38031,2102,13664,1594
1600000US0622230,0622230,"El Monte city, California",27249,1447,10912,1155,16337,1300
1600000US0622804,0622804,"Escondido city, California",45367,2011,22081,1711,23286,2238
1600000US0623182,0623182,"Fairfield city, California",38027,1435,21089,1689,16938,1577
1600000US0624477,0624477,"Florence-Graham CDP, California",15084,1309,5310,833,9774,1271
1600000US0624638,0624638,"Folsom city, California",27417,1441,19357,1242,8060,1183
1600000US0624680,0624680,"Fontana city, California",57868,2016,37298,2623,20570,1950
1600000US0626000,0626000,"Fremont city, California",71599,2346,41830,2474,29769,2225
1600000US0627000,0627000,"Fresno city, California",166288,3721,77261,3888,89027,4273
1600000US0628000,0628000,"Fullerton city, California",45635,2559,23334,2130,22301,1730
1600000US0629000,0629000,"Garden Grove city, California",47718,1711,24374,1760,23344,1828
1600000US0630000,0630000,"Glendale city, California",75013,2508,25130,1415,49883,2759
1600000US0632548,0632548,"Hawthorne city, California",28870,1563,7750,947,21120,1701
1600000US0633000,0633000,"Hayward city, California",45792,1757,23255,1476,22537,1842
1600000US0633182,0633182,"Hemet city, California",29465,2363,16155,1701,13310,1740
1600000US0633434,0633434,"Hesperia city, California",26802,1703,16496,1812,10306,1483
1600000US0636000,0636000,"Huntington Beach city, California",78998,2542,47198,2791,31800,2287
1600000US0636448,0636448,"Indio city, California",30887,2441,21176,2206,9711,1484
1600000US0636546,0636546,"Inglewood city, California",38724,2230,14052,1384,24672,2369
1600000US0636770,0636770,"Irvine city, California",94321,3397,45894,3320,48427,3592
1600000US0637692,0637692,"Jurupa Valley city, California",24850,1457,15256,1318,9594,1072
1600000US0639248,0639248,"Laguna Niguel city, California",24116,1365,16861,1449,7255,1229
1600000US0639496,0639496,"Lake Forest city, California",29496,1480,20205,1646,9291,1201
1600000US0639892,0639892,"Lakewood city, California",24806,1200,18058,1402,6748,1128
1600000US0640130,0640130,"Lancaster city, California",49934,2000,24035,1989,25899,2102
1600000US0641992,0641992,"Livermore city, California",30749,1443,21890,1681,8859,1250
1600000US0643000,0643000,"Long Beach city, California",160769,4397,60615,2992,100154,3998
1600000US0644000,0644000,"Los Angeles city, California",1378844,9016,494533,6531,884311,9060
1600000US0644574,0644574,"Lynwood city, California",14840,1017,5962,1038,8878,1056
1600000US0645484,0645484,"Manteca city, California",24828,1487,14325,1658,10503,1232
1600000US0646842,0646842,"Menifee city, California",29148,1559,21438,1597,7710,1257
1600000US0646898,0646898,"Merced city, California",24221,1535,8697,1291,15524,1376
1600000US0647766,0647766,"Milpitas city, California",22870,1036,14306,1313,8564,1062
1600000US0648256,0648256,"Mission Viejo city, California",33544,1636,24872,1590,8672,1231
1600000US0648354,0648354,"Modesto city, California",70591,2090,38688,2736,31903,2453
1600000US0649270,0649270,"Moreno Valley city, California",49785,2023,28145,1989,21640,1842
1600000US0649670,0649670,"Mountain View city, California",32696,1521,13214,1159,19482,1577
1600000US0650076,0650076,"Murrieta city, California",31090,1713,20950,1819,10140,1471
1600000US0650258,0650258,"Napa city, California",30017,1217,17087,1404,12930,1367
1600000US0651182,0651182,"Newport Beach city, California",37351,1822,21514,1518,15837,1906
1600000US0652526,0652526,"Norwalk city, California",26883,1220,16864,1391,10019,1196
1600000US0653000,0653000,"Oakland city, California",158084,3325,60549,2448,97535,2999
1600000US0653322,0653322,"Oceanside city, California",62661,2690,32014,2356,30647,2016
1600000US0653896,0653896,"Ontario city, California",49020,2176,26807,2313,22213,1854
1600000US0653980,0653980,"Orange city, California",43533,1625,23784,1781,19749,1700
1600000US0654652,0654652,"Oxnard city, California",49895,2240,26337,2064,23558,1939
1600000US0655156,0655156,"Palmdale city, California",44225,2143,27190,2024,17035,2045
1600000US0655282,0655282,"Palo Alto city, California",28228,1142,15506,1265,12722,1240
1600000US0656000,0656000,"Pasadena city, California",55291,2422,22860,1965,32431,2104
1600000US0656700,0656700,"Perris city, California",17261,1184,10643,1437,6618,1215
1600000US0657456,0657456,"Pittsburg city, California",20509,1204,11542,1263,8967,1282
1600000US0657792,0657792,"Pleasanton city, California",29774,1210,20930,1485,8844,1239
1600000US0658072,0658072,"Pomona city, California",35503,1760,17520,1399,17983,1402
1600000US0659444,0659444,"Rancho Cordova city, California",24611,1387,14220,1275,10391,1160
1600000US0659451,0659451,"Rancho Cucamonga city, California",57514,2727,33320,2308,24194,2371
1600000US0659920,0659920,"Redding city, California",36472,1518,20400,1535,16072,1685
1600000US0659962,0659962,"Redlands city, California",24217,1615,12892,1421,11325,1301
1600000US0660018,0660018,"Redondo Beach city, California",29688,1462,15936,1447,13752,1518
1600000US0660102,0660102,"Redwood City city, California",30293,1735,13960,1287,16333,1410
1600000US0660466,0660466,"Rialto city, California",26445,1420,16691,1240,9754,1387
1600000US0660620,0660620,"Richmond city, California",34949,1584,17949,1469,17000,1466
1600000US0662000,0662000,"Riverside city, California",91360,2584,47603,2291,43757,2851
1600000US0662938,0662938,"Roseville city, California",48500,1894,31516,1940,16984,1851
1600000US0664000,0664000,"Sacramento city, California",183212,4461,87140,3722,96072,3834
1600000US0664224,0664224,"Salinas city, California",39274,1704,16746,1349,22528,1714
1600000US0665000,0665000,"San Bernardino city, California",57920,2132,25782,1765,32138,2229
1600000US0665042,0665042,"San Buenaventura (Ventura) city, California",40630,1771,23022,1648,17608,1653
1600000US0665084,0665084,"San Clemente city, California",27741,1933,17635,1941,10106,1669
1600000US0666000,0666000,"San Diego city, California",495726,6457,226554,6028,269172,6695
1600000US0667000,0667000,"San Francisco city, California",358703,4561,136000,4239,222703,5063
1600000US0668000,0668000,"San Jose city, California",320447,4500,182315,3819,138132,4425
1600000US0668084,0668084,"San Leandro city, California",34977,2011,19979,2032,14998,1899
1600000US0668196,0668196,"San Marcos city, California",28706,1768,18278,1810,10428,1259
1600000US0668252,0668252,"San Mateo city, California",38710,1873,21215,1609,17495,1678
1600000US0668378,0668378,"San Ramon city, California",25847,1013,18488,1129,7359,1015
1600000US0669000,0669000,"Santa Ana city, California",74294,2337,33150,1983,41144,2095
1600000US0669070,0669070,"Santa Barbara city, California",36514,1421,14820,1615,21694,1760
1600000US0669084,0669084,"Santa Clara city, California",44392,2101,19517,1784,24875,1838
1600000US0669088,0669088,"Santa Clarita city, California",61687,2071,42517,2086,19170,1741
1600000US0669196,0669196,"Santa Maria city, California",27248,1632,12993,1372,14255,1382
1600000US0670000,0670000,"Santa Monica city, California",47265,2390,13089,1515,34176,2182
1600000US0670098,0670098,"Santa Rosa city, California",64202,2640,36122,2422,28080,2378
1600000US0672016,0672016,"Simi Valley city, California",41020,1690,29264,1794,11756,1442
1600000US0673080,0673080,"South Gate city, California",23762,1082,10076,940,13686,1280
1600000US0673262,0673262,"South San Francisco city, California",20881,2135,11830,1959,9051,1372
1600000US0675000,0675000,"Stockton city, California",95851,2087,44188,2310,51663,2471
1600000US0677000,0677000,"Sunnyvale city, California",56245,2106,25653,1908,30592,1877
1600000US0678120,0678120,"Temecula city, California",32551,1779,20261,1705,12290,1607
1600000US0678582,0678582,"Thousand Oaks city, California",46830,1678,33013,1956,13817,1647
1600000US0680000,0680000,"Torrance city, California",53614,1967,29321,2279,24293,1849
1600000US0680238,0680238,"Tracy city, California",26744,1427,15526,1594,11218,1656
1600000US0680812,0680812,"Turlock city, California",25137,1496,13382,1583,11755,1442
1600000US0680854,0680854,"Tustin city, California",27573,1708,12476,1535,15097,1498
1600000US0681204,0681204,"Union City city, California",21702,1016,13629,1222,8073,989
1600000US0681344,0681344,"Upland city, California",27326,1218,14003,1322,13323,1144
1600000US0681554,0681554,"Vacaville city, California",32697,1348,19996,1617,12701,1500
1600000US0681666,0681666,"Vallejo city, California",40419,1705,21545,1556,18874,1588
1600000US0682590,0682590,"Victorville city, California",32803,1941,17052,1921,15751,1741
1600000US0682954,0682954,"Visalia city, California",41357,1988,24940,2483,16417,2026
1600000US0682996,0682996,"Vista city, California",30416,1483,14604,1676,15812,1136
1600000US0683346,0683346,"Walnut Creek city, California",30542,1582,18468,1591,12074,1248
1600000US0684200,0684200,"West Covina city, California",30803,1201,17745,1416,13058,1260
1600000US0684550,0684550,"Westminster city, California",27587,1393,13486,1263,14101,1318
1600000US0685292,0685292,"Whittier city, California",27597,1514,15575,1302,12022,1307
1600000US0686832,0686832,"Yorba Linda city, California",21941,1139,17845,1252,4096,801
1600000US0686972,0686972,"Yuba City city, California",22096,916,10235,1257,11861,1262
1600000US0803455,0803455,"Arvada city, Colorado",45850,1594,33482,1882,12368,1495
1600000US0804000,0804000,"Aurora city, Colorado",127661,2626,73058,3350,54603,2868
1600000US0807850,0807850,"Boulder city, Colorado",40031,2008,20890,1729,19141,1468
1600000US0809280,0809280,"Broomfield city, Colorado",26269,479,17004,899,9265,963
1600000US0812815,0812815,"Centennial city, Colorado",39777,1816,31949,1659,7828,1179
1600000US0816000,0816000,"Colorado Springs city, Colorado",184681,2932,106202,3323,78479,3803
1600000US0820000,0820000,"Denver city, Colorado",292003,2724,145998,4477,146005,5051
1600000US0827425,0827425,"Fort Collins city, Colorado",63735,1959,33983,1824,29752,2123
1600000US0832155,0832155,"Greeley city, Colorado",36589,1660,20631,1504,15958,1612
1600000US0836410,0836410,"Highlands Ranch CDP, Colorado",40562,1564,32644,1433,7918,1160
1600000US0843000,0843000,"Lakewood city, Colorado",66185,2080,39281,2069,26904,1816
1600000US0845970,0845970,"Longmont city, Colorado",35176,1701,21960,1572,13216,1271
1600000US0846465,0846465,"Loveland city, Colorado",29780,1664,18285,1716,11495,1698
1600000US0862000,0862000,"Pueblo city, Colorado",42366,1589,23324,2008,19042,1784
1600000US0877290,0877290,"Thornton city, Colorado",45559,1969,33391,1977,12168,1562
1600000US0883835,0883835,"Westminster city, Colorado",43754,1876,27757,1742,15997,1508
1600000US0908000,0908000,"Bridgeport city, Connecticut",50476,2227,19997,1708,30479,1984
1600000US0918430,0918430,"Danbury city, Connecticut",30831,1564,17888,1585,12943,1563
1600000US0937000,0937000,"Hartford city, Connecticut",47033,2125,10179,1227,36854,2349
1600000US0950370,0950370,"New Britain city, Connecticut",29825,1474,10832,1468,18993,1379
1600000US0952000,0952000,"New Haven city, Connecticut",48909,2753,12689,1637,36220,2593
1600000US0955990,0955990,"Norwalk city, Connecticut",33989,1842,19940,1752,14049,1693
1600000US0973000,0973000,"Stamford city, Connecticut",47330,1932,24243,1895,23087,2053
1600000US0980000,0980000,"Waterbury city, Connecticut",38372,1982,14927,1440,23445,1853
1600000US1077580,1077580,"Wilmington city, Delaware",26185,1565,11612,1157,14573,1342
1600000US1150000,1150000,"Washington city, District of Columbia",281241,3152,110376,3494,170865,4218
1600000US1200410,1200410,"Alafaya CDP, Florida",29989,3070,18113,3072,11876,2808
1600000US1207300,1207300,"Boca Raton city, Florida",43103,2180,29774,2351,13329,1675
1600000US1207875,1207875,"Boynton Beach city, Florida",28885,1766,16557,1729,12328,1350
1600000US1208150,1208150,"Brandon CDP, Florida",40300,2432,22191,1861,18109,1859
1600000US1210275,1210275,"Cape Coral city, Florida",63098,3164,45260,2864,17838,2435
1600000US1212875,1212875,"Clearwater city, Florida",45459,2490,26113,2027,19346,1713
1600000US1214400,1214400,"Coral Springs city, Florida",43023,2073,24771,2024,18252,1830
1600000US1216475,1216475,"Davie town, Florida",34502,1925,22698,1920,11804,1661
1600000US1216525,1216525,"Daytona Beach city, Florida",30669,1955,14073,1566,16596,1958
1600000US1216725,1216725,"Deerfield Beach city, Florida",31275,2165,17929,1763,13346,1676
1600000US1217100,1217100,"Delray Beach city, Florida",26502,2115,15919,1696,10583,1585
1600000US1217200,1217200,"Deltona city, Florida",31155,2040,24101,2018,7054,1278
1600000US1224000,1224000,"Fort Lauderdale city, Florida",72896,3418,37736,2929,35160,2680
1600000US1224125,1224125,"Fort Myers city, Florida",27938,2027,12277,1437,15661,1499
1600000US1225175,1225175,"Gainesville city, Florida",48591,3105,17276,1677,31315,2745
1600000US1230000,1230000,"Hialeah city, Florida",75222,2648,32619,2592,42603,2179
1600000US1232000,1232000,"Hollywood city, Florida",57852,2464,33089,2036,24763,2136
1600000US1232275,1232275,"Homestead city, Florida",19057,1298,6504,1359,12553,1430
1600000US1235000,1235000,"Jacksonville city, Florida",331555,5147,187544,4977,144011,5221
1600000US1236100,1236100,"Kendall CDP, Florida",28831,2056,17306,1679,11525,1833
1600000US1236950,1236950,"Kissimmee city, Florida",21587,1769,8063,1279,13524,1825
1600000US1238250,1238250,"Lakeland city, Florida",40078,2088,23058,1845,17020,1605
1600000US1239425,1239425,"Largo city, Florida",38718,1939,22212,1874,16506,1805
1600000US1239550,1239550,"Lauderhill city, Florida",21551,1826,10026,1451,11525,1454
1600000US1239925,1239925,"Lehigh Acres CDP, Florida",30787,2187,18120,1623,12667,1604
1600000US1243975,1243975,"Melbourne city, Florida",31902,2014,18691,1805,13211,1667
1600000US1245000,1245000,"Miami city, Florida",172748,4896,51954,3300,120794,4619
1600000US1245025,1245025,"Miami Beach city, Florida",44963,2322,16809,1898,28154,2048
1600000US1245060,1245060,"Miami Gardens city, Florida",33174,2441,21435,2111,11739,1737
1600000US1245975,1245975,"Miramar city, Florida",41895,2399,28430,2472,13465,2057
1600000US1253000,1253000,"Orlando city, Florida",115977,3136,40612,3078,75365,3471
1600000US1254000,1254000,"Palm Bay city, Florida",37830,2022,27195,2210,10635,1651
1600000US1254200,1254200,"Palm Coast city, Florida",32446,1931,23505,1689,8941,1446
1600000US1255775,1255775,"Pembroke Pines city, Florida",57765,2556,40307,2715,17458,2281
1600000US1256825,1256825,"Pine Hills CDP, Florida",22976,2260,12531,1601,10445,1891
1600000US1257425,1257425,"Plantation city, Florida",33769,2085,19652,1701,14117,1655
1600000US1258050,1258050,"Pompano Beach city, Florida",39136,2075,19962,1938,19174,1654
1600000US1258715,1258715,"Port St. Lucie city, Florida",64360,3236,46001,3548,18359,3330
1600000US1260950,1260950,"Riverview CDP, Florida",30547,2195,19975,1648,10572,1761
1600000US1263000,1263000,"St. Petersburg city, Florida",109832,3780,64477,3385,45355,2738
1600000US1268350,1268350,"Spring Hill CDP, Florida",42168,1873,31452,1890,10716,1698
1600000US1269700,1269700,"Sunrise city, Florida",32671,2030,20867,1995,11804,1540
1600000US1270600,1270600,"Tallahassee city, Florida",75147,2673,28461,1682,46686,2658
1600000US1270675,1270675,"Tamarac city, Florida",25951,1943,18573,1679,7378,1443
1600000US1271000,1271000,"Tampa city, Florida",151167,3886,71263,3500,79904,3383
1600000US1271569,1271569,"The Hammocks CDP, Florida",16890,1807,9189,1146,7701,1574
1600000US1271625,1271625,"The Villages CDP, Florida",38271,2387,37013,2468,1258,657
1600000US1272145,1272145,"Town 'n' Country CDP, Florida",31705,2184,19086,1702,12619,1542
1600000US1276582,1276582,"Weston city, Florida",21053,1238,16509,1339,4544,1140
1600000US1276600,1276600,"West Palm Beach city, Florida",41679,2687,19173,1992,22506,1977
1600000US1301052,1301052,"Albany city, Georgia",28054,1524,10928,1132,17126,1615
1600000US1301696,1301696,"Alpharetta city, Georgia",23559,1534,14609,1529,8950,1343
1600000US1303440,1303440,"Athens-Clarke County unified government (balance), Georgia",47020,1388,15738,1300,31282,1610
1600000US1304000,1304000,"Atlanta city, Georgia",193815,5654,80001,3665,113814,5356
1600000US1304204,1304204,"Augusta-Richmond County consolidated government (balance), Georgia",73962,2054,39129,2210,34833,2714
1600000US1319000,1319000,"Columbus city, Georgia",73051,2017,33833,1878,39218,2207
1600000US1342425,1342425,"Johns Creek city, Georgia",27227,1524,20995,1719,6232,1361
1600000US1349008,1349008,"Macon-Bibb County, Georgia",57642,1767,29657,1707,27985,2046
1600000US1367284,1367284,"Roswell city, Georgia",32537,1600,21747,1864,10790,1571
1600000US1368516,1368516,"Sandy Springs city, Georgia",45183,2449,20896,2042,24287,2177
1600000US1369000,1369000,"Savannah city, Georgia",55363,2242,23290,1931,32073,2216
1600000US1380508,1380508,"Warner Robins city, Georgia",29590,1585,16664,1871,12926,2018
1600000US1571550,1571550,"Urban Honolulu CDP, Hawaii",128883,3059,53763,2678,75120,2915
1600000US1608830,1608830,"Boise City city, Idaho",89012,3091,53372,3085,35640,2577
1600000US1652120,1652120,"Meridian city, Idaho",33458,2289,25337,2193,8121,2257
1600000US1656260,1656260,"Nampa city, Idaho",30041,1745,17921,1772,12120,1739
1600000US1702154,1702154,"Arlington Heights village, Illinois",30610,1760,23567,1773,7043,1201
1600000US1703012,1703012,"Aurora city, Illinois",62913,2213,39596,2461,23317,1826
1600000US1706613,1706613,"Bloomington city, Illinois",32784,1274,19778,1315,13006,1545
1600000US1707133,1707133,"Bolingbrook village, Illinois",22954,1422,18949,1358,4005,994
1600000US1712385,1712385,"Champaign city, Illinois",34343,2132,16245,1312,18098,2006
1600000US1714000,1714000,"Chicago city, Illinois",1053986,9730,460612,8445,593374,10029
1600000US1714351,1714351,"Cicero town, Illinois",22495,1179,10323,1238,12172,1476
1600000US1718823,1718823,"Decatur city, Illinois",30770,1315,18046,1179,12724,1205
1600000US1723074,1723074,"Elgin city, Illinois",36969,1919,25388,2010,11581,1475
1600000US1724582,1724582,"Evanston city, Illinois",29073,1667,16326,1485,12747,1476
1600000US1738570,1738570,"Joliet city, Illinois",47921,2244,34182,1908,13739,1479
1600000US1751622,1751622,"Naperville city, Illinois",50672,1434,37456,1409,13216,1397
1600000US1757225,1757225,"Palatine village, Illinois",26743,1627,19014,1817,7729,1114
1600000US1759000,1759000,"Peoria city, Illinois",46774,1599,25769,1565,21005,1659
1600000US1765000,1765000,"Rockford city, Illinois",60659,1796,30175,1623,30484,2072
1600000US1768003,1768003,"Schaumburg village, Illinois",29556,1457,20233,1667,9323,1221
1600000US1770122,1770122,"Skokie village, Illinois",22461,1339,15054,1686,7407,1134
1600000US1772000,1772000,"Springfield city, Illinois",50310,1468,32553,1503,17757,1626
1600000US1779293,1779293,"Waukegan city, Illinois",28476,1538,12948,1283,15528,1539
1600000US1805860,1805860,"Bloomington city, Indiana",30366,1926,10865,1346,19501,1953
1600000US1810342,1810342,"Carmel city, Indiana",32863,1410,26141,1564,6722,1122
1600000US1822000,1822000,"Evansville city, Indiana",51199,1629,25956,1680,25243,1899
1600000US1823278,1823278,"Fishers city, Indiana",32839,1752,26255,1981,6584,1332
1600000US1825000,1825000,"Fort Wayne city, Indiana",103942,2085,62934,2771,41008,2223
1600000US1827000,1827000,"Gary city, Indiana",31809,1700,16206,1634,15603,1613
1600000US1831000,1831000,"Hammond city, Indiana",27332,1548,16238,1306,11094,1409
1600000US1836003,1836003,"Indianapolis city (balance), Indiana",332643,3933,174250,4173,158393,4868
1600000US1840788,1840788,"Lafayette city, Indiana",31819,1829,15757,1663,16062,1663
1600000US1851876,1851876,"Muncie city, Indiana",28042,1457,15438,1472,12604,1325
1600000US1871000,1871000,"South Bend city, Indiana",37234,1938,20409,1727,16825,1764
1600000US1901855,1901855,"Ames city, Iowa",25185,1172,9560,988,15625,1106
1600000US1912000,1912000,"Cedar Rapids city, Iowa",54445,1814,37903,1764,16542,1807
1600000US1919000,1919000,"Davenport city, Iowa",39481,1494,24755,1449,14726,1437
1600000US1921000,1921000,"Des Moines city, Iowa",82837,2704,48681,2320,34156,2090
1600000US1938595,1938595,"Iowa City city, Iowa",30431,1698,14489,1310,15942,1773
1600000US1973335,1973335,"Sioux City city, Iowa",31097,1319,19622,1699,11475,1468
1600000US1982425,1982425,"Waterloo city, Iowa",28113,1167,16623,1392,11490,1403
1600000US2036000,2036000,"Kansas City city, Kansas",54655,1358,29894,1479,24761,1646
1600000US2038900,2038900,"Lawrence city, Kansas",36506,1481,16515,1614,19991,1899
1600000US2052575,2052575,"Olathe city, Kansas",46897,1903,33236,1642,13661,1595
1600000US2053775,2053775,"Overland Park city, Kansas",76554,2187,47352,2405,29202,2046
1600000US2064500,2064500,"Shawnee city, Kansas",24734,1562,18351,1533,6383,1448
1600000US2071000,2071000,"Topeka city, Kansas",51471,1874,27559,1675,23912,1899
1600000US2079000,2079000,"Wichita city, Kansas",151885,2630,90243,2869,61642,2779
1600000US2108902,2108902,"Bowling Green city, Kentucky",24485,1375,9199,1253,15286,1149
1600000US2146027,2146027,"Lexington-Fayette urban county, Kentucky",127137,2102,70701,2349,56436,2371
1600000US2148006,2148006,"Louisville/Jefferson County metro government (balance), Kentucky",251788,3155,145605,4112,106183,3933
1600000US2205000,2205000,"Baton Rouge city, Louisiana",81939,3541,38315,2476,43624,2595
1600000US2208920,2208920,"Bossier City city, Louisiana",24904,1699,13078,1452,11826,1734
1600000US2239475,2239475,"Kenner city, Louisiana",24208,1448,13953,1467,10255,1496
1600000US2240735,2240735,"Lafayette city, Louisiana",50473,2109,29144,2134,21329,2020
1600000US2241155,2241155,"Lake Charles city, Louisiana",30546,1623,16287,1606,14259,2046
1600000US2250115,2250115,"Metairie CDP, Louisiana",60296,2710,35292,2240,25004,2579
1600000US2255000,2255000,"New Orleans city, Louisiana",154355,2906,71518,2697,82837,2901
1600000US2270000,2270000,"Shreveport city, Louisiana",75509,2289,38351,2503,37158,2771
1600000US2360545,2360545,"Portland city, Maine",30179,1600,11951,1257,18228,1529
1600000US2404000,2404000,"Baltimore city, Maryland",240761,4046,110146,3498,130615,3787
1600000US2419125,2419125,"Columbia CDP, Maryland",41521,1692,27400,1714,14121,1804
1600000US2426000,2426000,"Ellicott City CDP, Maryland",23747,1179,17634,1081,6113,1205
1600000US2430325,2430325,"Frederick city, Maryland",27035,1252,14390,1203,12645,1441
1600000US2431175,2431175,"Gaithersburg city, Maryland",23759,1401,12019,1281,11740,1214
1600000US2432025,2432025,"Germantown CDP, Maryland",31001,2284,18646,1672,12355,1705
1600000US2432650,2432650,"Glen Burnie CDP, Maryland",27309,2100,16193,1537,11116,1857
1600000US2467675,2467675,"Rockville city, Maryland",24370,1518,13897,1532,10473,1044
1600000US2472450,2472450,"Silver Spring CDP, Maryland",34994,2244,11685,1116,23309,2151
1600000US2481175,2481175,"Waldorf CDP, Maryland",26854,1550,18630,1512,8224,1319
1600000US2507000,2507000,"Boston city, Massachusetts",267592,3881,93649,3421,173943,4306
1600000US2509000,2509000,"Brockton city, Massachusetts",30572,1632,16327,1631,14245,1689
1600000US2511000,2511000,"Cambridge city, Massachusetts",43973,2221,14457,1264,29516,2023
1600000US2523000,2523000,"Fall River city, Massachusetts",37002,1798,13792,1620,23210,2019
1600000US2524960,2524960,"Framingham CDP, Massachusetts",28952,1417,16238,1437,12714,1343
1600000US2534550,2534550,"Lawrence city, Massachusetts",24566,1462,7624,1173,16942,1619
1600000US2537000,2537000,"Lowell city, Massachusetts",38046,1875,16320,1587,21726,2113
1600000US2537490,2537490,"Lynn city, Massachusetts",33635,1801,15501,1634,18134,1540
1600000US2545000,2545000,"New Bedford city, Massachusetts",39425,1388,15494,1557,23931,1601
1600000US2545560,2545560,"Newton city, Massachusetts",30309,1397,22010,1140,8299,995
1600000US2555745,2555745,"Quincy city, Massachusetts",39974,1831,18372,1719,21602,1812
1600000US2562535,2562535,"Somerville city, Massachusetts",31495,1639,10842,1445,20653,1584
1600000US2567000,2567000,"Springfield city, Massachusetts",55894,2220,26326,1838,29568,1939
1600000US2582000,2582000,"Worcester city, Massachusetts",72092,2699,29613,2065,42479,2792
1600000US2603000,2603000,"Ann Arbor city, Michigan",48343,1769,21529,1349,26814,1604
1600000US2621000,2621000,"Dearborn city, Michigan",31162,1845,18972,1535,12190,1436
1600000US2622000,2622000,"Detroit city, Michigan",259295,4821,119226,3802,140069,4528
1600000US2627440,2627440,"Farmington Hills city, Michigan",35360,1587,21354,1388,14006,1390
1600000US2629000,2629000,"Flint city, Michigan",38859,1884,21253,1936,17606,1819
1600000US2634000,2634000,"Grand Rapids city, Michigan",73880,2222,39882,2060,33998,2007
1600000US2642160,2642160,"Kalamazoo city, Michigan",27790,1698,12563,1352,15227,1442
1600000US2646000,2646000,"Lansing city, Michigan",49334,1973,24485,1830,24849,1711
1600000US2649000,2649000,"Livonia city, Michigan",37441,1240,31301,1374,6140,968
1600000US2669035,2669035,"Rochester Hills city, Michigan",27843,1254,21204,1434,6639,898
1600000US2674900,2674900,"Southfield city, Michigan",33963,1663,15454,1327,18509,1595
1600000US2676460,2676460,"Sterling Heights city, Michigan",48904,1831,35718,1979,13186,1707
1600000US2680700,2680700,"Troy city, Michigan",32801,1224,24009,1084,8792,1114
1600000US2684000,2684000,"Warren city, Michigan",52164,1736,35820,2171,16344,1680
1600000US2686000,2686000,"Westland city, Michigan",36968,1648,21471,1488,15497,1242
1600000US2688940,2688940,"Wyoming city, Michigan",27985,1438,18567,1703,9418,1320
1600000US2706616,2706616,"Bloomington city, Minnesota",36866,1643,23876,1715,12990,1335
1600000US2707966,2707966,"Brooklyn Park city, Minnesota",27711,1990,19175,1822,8536,1263
1600000US2717000,2717000,"Duluth city, Minnesota",35137,1556,21225,1266,13912,1492
1600000US2717288,2717288,"Eagan city, Minnesota",27062,1174,18201,1252,8861,1249
1600000US2740166,2740166,"Maple Grove city, Minnesota",25244,1212,21730,1150,3514,786
1600000US2743000,2743000,"Minneapolis city, Minnesota",171906,3741,80243,2899,91663,3465
1600000US2751730,2751730,"Plymouth city, Minnesota",30648,1327,21326,1444,9322,1390
1600000US2754880,2754880,"Rochester city, Minnesota",46478,1171,32325,1506,14153,1399
1600000US2756896,2756896,"St. Cloud city, Minnesota",26515,1417,13238,1124,13277,1359
1600000US2758000,2758000,"St. Paul city, Minnesota",112803,2654,56236,2099,56567,2429
1600000US2771428,2771428,"Woodbury city, Minnesota",23086,1139,18042,1212,5044,1121
1600000US2829700,2829700,"Gulfport city, Mississippi",27723,1801,14479,1589,13244,1614
1600000US2836000,2836000,"Jackson city, Mississippi",64929,1691,34014,2255,30915,2268
1600000US2915670,2915670,"Columbia city, Missouri",47982,1981,21497,1880,26485,2103
1600000US2935000,2935000,"Independence city, Missouri",48151,2137,28346,1978,19805,1833
1600000US2938000,2938000,"Kansas City city, Missouri",198202,3931,104990,3628,93212,3677
1600000US2941348,2941348,"Lee's Summit city, Missouri",35217,1522,26843,1546,8374,1322
1600000US2954074,2954074,"O'Fallon city, Missouri",30696,1302,25611,1310,5085,1048
1600000US2964082,2964082,"St. Charles city, Missouri",28060,1730,18593,1832,9467,1417
1600000US2964550,2964550,"St. Joseph city, Missouri",29434,1168,17206,1412,12228,1489
1600000US2965000,2965000,"St. Louis city, Missouri",139021,3248,60598,2809,78423,3836
1600000US2970000,2970000,"Springfield city, Missouri",74126,2114,30646,2052,43480,2245
1600000US3006550,3006550,"Billings city, Montana",46477,1501,29559,1722,16918,1948
1600000US3050200,3050200,"Missoula city, Montana",30350,1325,13931,1513,16419,1667
1600000US3128000,3128000,"Lincoln city, Nebraska",112386,2187,63046,2010,49340,2338
1600000US3137000,3137000,"Omaha city, Nebraska",175881,2312,99592,2576,76289,2830
1600000US3223770,3223770,"Enterprise CDP, Nevada",46851,3154,26699,2295,20152,2078
1600000US3231900,3231900,"Henderson city, Nevada",110948,3066,71366,2923,39582,2756
1600000US3240000,3240000,"Las Vegas city, Nevada",223819,4854,118023,3837,105796,3902
1600000US3251800,3251800,"North Las Vegas city, Nevada",71898,2796,39256,2854,32642,2688
1600000US3254600,3254600,"Paradise CDP, Nevada",90237,3782,33584,2030,56653,3612
1600000US3260600,3260600,"Reno city, Nevada",96742,2577,44246,2345,52496,2959
1600000US3268400,3268400,"Sparks city, Nevada",37218,1912,21577,1828,15641,1949
1600000US3268585,3268585,"Spring Valley CDP, Nevada",75225,3262,31116,2234,44109,3193
1600000US3271400,3271400,"Sunrise Manor CDP, Nevada",60814,2710,28497,1724,32317,2398
1600000US3345140,3345140,"Manchester city, New Hampshire",46141,1594,19201,1662,26940,1538
1600000US3350260,3350260,"Nashua city, New Hampshire",35663,1703,18383,1639,17280,1601
1600000US3403580,3403580,"Bayonne city, New Jersey",25222,1587,9611,1139,15611,1583
1600000US3410000,3410000,"Camden city, New Jersey",24505,1571,9169,1471,15336,1534
1600000US3413690,3413690,"Clifton city, New Jersey",28998,1494,16784,1847,12214,1506
1600000US3419390,3419390,"East Orange city, New Jersey",22751,1471,5219,746,17532,1565
1600000US3421000,3421000,"Elizabeth city, New Jersey",41026,1829,10316,1311,30710,2039
1600000US3436000,3436000,"Jersey City city, New Jersey",99715,2607,26606,2276,73109,2494
1600000US3451000,3451000,"Newark city, New Jersey",99576,2632,20839,2096,78737,2955
1600000US3456550,3456550,"Passaic city, New Jersey",19276,1282,4464,792,14812,1303
1600000US3457000,3457000,"Paterson city, New Jersey",46531,1720,10803,1459,35728,1935
1600000US3473110,3473110,"Toms River CDP, New Jersey",33456,1589,27086,1604,6370,1221
1600000US3474000,3474000,"Trenton city, New Jersey",26849,1781,9389,1257,17460,1520
1600000US3474630,3474630,"Union City city, New Jersey",24642,1147,5628,921,19014,1434
1600000US3502000,3502000,"Albuquerque city, New Mexico",220918,2957,133470,4363,87448,4033
1600000US3539380,3539380,"Las Cruces city, New Mexico",39169,1776,19886,1851,19283,2217
1600000US3563460,3563460,"Rio Rancho city, New Mexico",34795,1090,29004,1512,5791,1170
1600000US3570500,3570500,"Santa Fe city, New Mexico",34975,1517,21489,1436,13486,1346
1600000US3601000,3601000,"Albany city, New York",41143,2071,14520,1691,26623,2239
1600000US3608026,3608026,"Brentwood CDP, New York",13383,1323,9575,1062,3808,1207
1600000US3611000,3611000,"Buffalo city, New York",106139,2998,41804,2414,64335,3139
1600000US3615000,3615000,"Cheektowaga CDP, New York",32626,1577,22568,1511,10058,1562
1600000US3649121,3649121,"Mount Vernon city, New York",24658,1576,9429,971,15229,1637
1600000US3650617,3650617,"New Rochelle city, New York",28795,1765,14115,1401,14680,1664
1600000US3651000,3651000,"New York city, New York",3114811,11631,998198,11651,2116613,16512
1600000US3663000,3663000,"Rochester city, New York",84688,2818,28800,2000,55888,2647
1600000US3665508,3665508,"Schenectady city, New York",20407,1677,9707,1365,10700,1377
1600000US3673000,3673000,"Syracuse city, New York",56295,2177,21992,1521,34303,2046
1600000US3684000,3684000,"Yonkers city, New York",72040,2362,33647,2675,38393,2252
1600000US3702140,3702140,"Asheville city, North Carolina",37527,1859,17838,1702,19689,1821
1600000US3710740,3710740,"Cary town, North Carolina",60298,1772,43243,2249,17055,1624
1600000US3712000,3712000,"Charlotte city, North Carolina",319816,3520,166963,3417,152853,4429
1600000US3714100,3714100,"Concord city, North Carolina",31432,1499,21053,1528,10379,1300
1600000US3719000,3719000,"Durham city, North Carolina",106400,2238,50759,2848,55641,3236
1600000US3722920,3722920,"Fayetteville city, North Carolina",79645,2226,36606,2123,43039,2108
1600000US3725580,3725580,"Gastonia city, North Carolina",29559,1426,16441,1263,13118,1379
1600000US3728000,3728000,"Greensboro city, North Carolina",113922,2613,55756,2424,58166,2870
1600000US3728080,3728080,"Greenville city, North Carolina",37921,1889,11799,1771,26122,1984
1600000US3731400,3731400,"High Point city, North Carolina",43265,2413,21886,1852,21379,2225
1600000US3734200,3734200,"Jacksonville city, North Carolina",19925,1598,6952,1247,12973,1579
1600000US3755000,3755000,"Raleigh city, North Carolina",180773,4669,88784,3469,91989,4787
1600000US3774440,3774440,"Wilmington city, North Carolina",50083,2470,21668,1898,28415,2351
1600000US3775000,3775000,"Winston-Salem city, North Carolina",95506,2362,52182,2556,43324,2773
1600000US3807200,3807200,"Bismarck city, North Dakota",30628,1302,19736,1242,10892,1309
1600000US3825700,3825700,"Fargo city, North Dakota",55368,1786,23621,1593,31747,2268
1600000US3901000,3901000,"Akron city, Ohio",83071,2714,41271,2478,41800,2636
1600000US3912000,3912000,"Canton city, Ohio",29592,1825,14634,1524,14958,1529
1600000US3915000,3915000,"Cincinnati city, Ohio",135565,3185,51482,2809,84083,3735
1600000US3916000,3916000,"Cleveland city, Ohio",168306,3533,70414,3327,97892,3399
1600000US3918000,3918000,"Columbus city, Ohio",349113,5053,153511,5119,195602,5764
1600000US3921000,3921000,"Dayton city, Ohio",58722,2502,27519,2189,31203,2636
1600000US3944856,3944856,"Lorain city, Ohio",26325,1310,15279,1448,11046,1220
1600000US3961000,3961000,"Parma city, Ohio",33376,1607,23517,1580,9859,1176
1600000US3977000,3977000,"Toledo city, Ohio",118122,2335,56880,2386,61242,3071
1600000US3988000,3988000,"Youngstown city, Ohio",26697,1745,15612,1350,11085,1253
1600000US4009050,4009050,"Broken Arrow city, Oklahoma",40978,1212,30354,1325,10624,988
1600000US4023200,4023200,"Edmond city, Oklahoma",32433,1506,22164,1471,10269,1414
1600000US4041850,4041850,"Lawton city, Oklahoma",33440,1549,14714,1434,18726,1405
1600000US4052500,4052500,"Norman city, Oklahoma",47571,1867,26188,1771,21383,2168
1600000US4055000,4055000,"Oklahoma City city, Oklahoma",241046,2948,142597,3531,98449,3413
1600000US4075000,4075000,"Tulsa city, Oklahoma",165545,2003,81546,2164,83999,2568
1600000US4105350,4105350,"Beaverton city, Oregon",40190,1732,19918,1601,20272,1717
1600000US4105800,4105800,"Bend city, Oregon",37021,1820,21592,2247,15429,2216
1600000US4123850,4123850,"Eugene city, Oregon",67993,2103,33102,2391,34891,2390
1600000US4131250,4131250,"Gresham city, Oregon",39646,2117,21201,1801,18445,1913
1600000US4134100,4134100,"Hillsboro city, Oregon",36132,2054,19182,1815,16950,1911
1600000US4147000,4147000,"Medford city, Oregon",34952,2208,17370,1854,17582,1700
1600000US4159000,4159000,"Portland city, Oregon",263774,3578,137111,4505,126663,4285
1600000US4164900,4164900,"Salem city, Oregon",60439,2185,33018,2309,27421,2276
1600000US4202000,4202000,"Allentown city, Pennsylvania",41625,1803,17699,1830,23926,1988
1600000US4206088,4206088,"Bethlehem city, Pennsylvania",28912,1804,14765,1403,14147,1706
1600000US4224000,4224000,"Erie city, Pennsylvania",40028,1614,20687,1428,19341,1609
1600000US4260000,4260000,"Philadelphia city, Pennsylvania",580205,5087,302498,6177,277707,5673
1600000US4261000,4261000,"Pittsburgh city, Pennsylvania",136300,3277,64314,2789,71986,3366
1600000US4263624,4263624,"Reading city, Pennsylvania",26783,1839,10926,1214,15857,1604
1600000US4269000,4269000,"Scranton city, Pennsylvania",30631,1586,14699,1471,15932,1413
1600000US4419180,4419180,"Cranston city, Rhode Island",31154,2094,21488,1564,9666,1530
1600000US4454640,4454640,"Pawtucket city, Rhode Island",27316,1574,11621,1028,15695,1444
1600000US4459000,4459000,"Providence city, Rhode Island",58170,2738,19241,2082,38929,2795
1600000US4474300,4474300,"Warwick city, Rhode Island",35208,1705,23403,1756,11805,1579
1600000US4513330,4513330,"Charleston city, South Carolina",57854,2701,32746,2237,25108,2188
1600000US4516000,4516000,"Columbia city, South Carolina",47289,2118,21746,1663,25543,2266
1600000US4530850,4530850,"Greenville city, South Carolina",29281,1537,12709,1278,16572,1649
1600000US4548535,4548535,"Mount Pleasant town, South Carolina",31552,2242,22149,1893,9403,1772
1600000US4550875,4550875,"North Charleston city, South Carolina",43248,2837,19430,2036,23818,2443
1600000US4561405,4561405,"Rock Hill city, South Carolina",27812,1487,13282,1364,14530,1477
1600000US4652980,4652980,"Rapid City city, South Dakota",29331,1405,18154,1231,11177,1336
1600000US4659020,4659020,"Sioux Falls city, South Dakota",69330,1580,42147,1919,27183,1856
1600000US4714000,4714000,"Chattanooga city, Tennessee",72349,3091,39698,2759,32651,2188
1600000US4715160,4715160,"Clarksville city, Tennessee",54765,1663,30080,2242,24685,2334
1600000US4727740,4727740,"Franklin city, Tennessee",28255,1002,18359,1529,9896,1384
1600000US4737640,4737640,"Jackson city, Tennessee",26287,1471,14045,1395,12242,1568
1600000US4738320,4738320,"Johnson City city, Tennessee",29071,1490,15065,1444,14006,1572
1600000US4740000,4740000,"Knoxville city, Tennessee",81005,2747,36254,2195,44751,2504
1600000US4748000,4748000,"Memphis city, Tennessee",256973,4572,112762,3927,144211,4748
1600000US4751560,4751560,"Murfreesboro city, Tennessee",49371,1866,26615,2050,22756,2054
1600000US4752006,4752006,"Nashville-Davidson metropolitan government (balance), Tennessee",271680,3287,143980,3703,127700,3716
1600000US4801000,4801000,"Abilene city, Texas",42424,1785,22359,1487,20065,1884
1600000US4801924,4801924,"Allen city, Texas",33337,1588,25051,1702,8286,1288
1600000US4803000,4803000,"Amarillo city, Texas",74687,1961,44827,2459,29860,2027
1600000US4804000,4804000,"Arlington city, Texas",135348,3815,75088,3663,60260,3628
1600000US4804462,4804462,"Atascocita CDP, Texas",24309,2629,19803,2634,4506,1317
1600000US4805000,4805000,"Austin city, Texas",372327,5397,167132,4323,205195,4934
1600000US4806128,4806128,"Baytown city, Texas",25195,1377,13300,1125,11895,1413
1600000US4807000,4807000,"Beaumont city, Texas",45642,1784,23492,2070,22150,2166
1600000US4810768,4810768,"Brownsville city, Texas",50289,1946,32141,1929,18148,1767
1600000US4810912,4810912,"Bryan city, Texas",29065,1596,14440,1456,14625,1800
1600000US4813024,4813024,"Carrollton city, Texas",49099,2013,28656,1791,20443,1757
1600000US4813552,4813552,"Cedar Park city, Texas",22188,1802,15536,1606,6652,1488
1600000US4815976,4815976,"College Station city, Texas",40098,1668,13755,1397,26343,1890
1600000US4816432,4816432,"Conroe city, Texas",29022,2213,14973,1738,14049,1966
1600000US4817000,4817000,"Corpus Christi city, Texas",116916,3162,65987,2820,50929,3018
1600000US4819000,4819000,"Dallas city, Texas",514588,5379,209784,4867,304804,5630
1600000US4819972,4819972,"Denton city, Texas",45320,2284,20338,1543,24982,2423
1600000US4822660,4822660,"Edinburg city, Texas",27010,1659,15513,1721,11497,1706
1600000US4824000,4824000,"El Paso city, Texas",225891,3025,130767,4285,95124,4613
1600000US4826232,4826232,"Flower Mound town, Texas",23493,949,20047,1098,3446,717
1600000US4827000,4827000,"Fort Worth city, Texas",287401,4732,164109,4740,123292,5785
1600000US4827684,4827684,"Frisco city, Texas",55493,1465,41580,1623,13913,1643
1600000US4829000,4829000,"Garland city, Texas",75219,2556,44403,2936,30816,2324
1600000US4829336,4829336,"Georgetown city, Texas",25235,1783,18525,1833,6710,1337
1600000US4830464,4830464,"Grand Prairie city, Texas",61773,2599,38330,2173,23443,2312
1600000US4832372,4832372,"Harlingen city, Texas",21872,1385,11119,1539,10753,1528
1600000US4835000,4835000,"Houston city, Texas",867915,8198,374439,8033,493476,8274
1600000US4837000,4837000,"Irving city, Texas",85407,2706,32730,2152,52677,2673
1600000US4839148,4839148,"Killeen city, Texas",52417,2251,22607,2290,29810,2244
1600000US4841464,4841464,"Laredo city, Texas",69849,1556,43955,2052,25894,1993
1600000US4841980,4841980,"League City city, Texas",35193,2219,25437,1928,9756,1724
1600000US4842508,4842508,"Lewisville city, Texas",39805,1957,17638,1460,22167,1979
1600000US4843888,4843888,"Longview city, Texas",30502,1661,15964,1638,14538,1706
1600000US4845000,4845000,"Lubbock city, Texas",93891,2377,48831,2588,45060,2292
1600000US4845384,4845384,"McAllen city, Texas",44903,2428,26862,2106,18041,2138
1600000US4845744,4845744,"McKinney city, Texas",59705,2210,40760,2192,18945,2030
1600000US4846452,4846452,"Mansfield city, Texas",21431,1100,14257,1145,7174,1191
1600000US4847892,4847892,"Mesquite city, Texas",46121,2507,26275,2187,19846,2153
1600000US4848072,4848072,"Midland city, Texas",46915,1669,27605,2021,19310,1838
1600000US4848768,4848768,"Mission city, Texas",24318,1549,14614,1962,9704,1598
1600000US4848804,4848804,"Missouri City city, Texas",25169,1730,20305,1687,4864,1484
1600000US4850820,4850820,"New Braunfels city, Texas",25887,1553,16392,1765,9495,1318
1600000US4852356,4852356,"North Richland Hills city, Texas",27115,1257,16143,1510,10972,1663
1600000US4853388,4853388,"Odessa city, Texas",40481,1751,24544,2083,15937,1889
1600000US4856000,4856000,"Pasadena city, Texas",47930,2276,23558,1840,24372,2292
1600000US4856348,4856348,"Pearland city, Texas",38606,2513,29934,1916,8672,2212
1600000US4857200,4857200,"Pharr city, Texas",21501,1500,12250,1624,9251,1640
1600000US4858016,4858016,"Plano city, Texas",106062,2861,65493,2674,40569,2506
1600000US4861796,4861796,"Richardson city, Texas",43095,1962,24649,1940,18446,1796
1600000US4863500,4863500,"Round Rock city, Texas",37060,2045,21910,1994,15150,1968
1600000US4864472,4864472,"San Angelo city, Texas",37703,1678,21601,1876,16102,1805
1600000US4865000,4865000,"San Antonio city, Texas",498154,4880,267058,5811,231096,5720
1600000US4870808,4870808,"Sugar Land city, Texas",28690,1439,23207,1284,5483,1263
1600000US4872176,4872176,"Temple city, Texas",27942,1566,15429,1647,12513,1504
1600000US4872656,4872656,"The Woodlands CDP, Texas",39942,2651,27307,2416,12635,2299
1600000US4874144,4874144,"Tyler city, Texas",36812,2172,18437,2216,18375,1569
1600000US4875428,4875428,"Victoria city, Texas",23191,1372,12382,1463,10809,1291
1600000US4876000,4876000,"Waco city, Texas",47966,1686,22216,1813,25750,2086
1600000US4879000,4879000,"Wichita Falls city, Texas",38585,2004,20135,1617,18450,1884
1600000US4943660,4943660,"Layton city, Utah",24166,1305,16242,1597,7924,1419
1600000US4955980,4955980,"Ogden city, Utah",28511,1648,16502,1523,12009,1351
1600000US4957300,4957300,"Orem city, Utah",28873,1362,16893,1326,11980,1486
1600000US4962470,4962470,"Provo city, Utah",30531,1504,11189,1082,19342,1559
1600000US4965330,4965330,"St. George city, Utah",26601,1862,17216,1808,9385,1675
1600000US4967000,4967000,"Salt Lake City city, Utah",76982,2372,36326,2244,40656,2498
1600000US4967440,4967440,"Sandy city, Utah",31740,1460,26686,1344,5054,1017
1600000US4970850,4970850,"South Jordan city, Utah",20979,1344,16291,1515,4688,1101
1600000US4982950,4982950,"West Jordan city, Utah",32556,1505,23783,1630,8773,1256
1600000US4983470,4983470,"West Valley City city, Utah",37400,1782,25668,1791,11732,1594
1600000US5101000,5101000,"Alexandria city, Virginia",69875,1555,27764,1841,42111,2131
1600000US5103000,5103000,"Arlington CDP, Virginia",103479,2496,46126,1830,57353,2799
1600000US5114440,5114440,"Centreville CDP, Virginia",22245,1287,14915,1180,7330,1215
1600000US5116000,5116000,"Chesapeake city, Virginia",83364,1894,58966,2398,24398,2434
1600000US5121088,5121088,"Dale City CDP, Virginia",20692,1597,15530,1285,5162,1212
1600000US5135000,5135000,"Hampton city, Virginia",54181,1387,30773,1867,23408,1872
1600000US5147672,5147672,"Lynchburg city, Virginia",27545,1610,13472,1600,14073,2036
1600000US5156000,5156000,"Newport News city, Virginia",67628,2268,33415,1947,34213,2174
1600000US5157000,5157000,"Norfolk city, Virginia",87910,2122,36007,1919,51903,2579
1600000US5164000,5164000,"Portsmouth city, Virginia",36615,1104,19466,1407,17149,1545
1600000US5167000,5167000,"Richmond city, Virginia",91704,1869,37877,2019,53827,2196
1600000US5168000,5168000,"Roanoke city, Virginia",42213,1450,22314,1823,19899,1970
1600000US5176432,5176432,"Suffolk city, Virginia",33377,896,22115,1214,11262,1306
1600000US5182000,5182000,"Virginia Beach city, Virginia",168061,2472,104596,3303,63465,3324
1600000US5303180,5303180,"Auburn city, Washington",29453,1795,17418,1403,12035,1431
1600000US5305210,5305210,"Bellevue city, Washington",56289,1716,32416,2060,23873,2055
1600000US5305280,5305280,"Bellingham city, Washington",34317,2168,13946,1416,20371,1660
1600000US5322640,5322640,"Everett city, Washington",42175,2437,18158,1983,24017,1968
1600000US5323515,5323515,"Federal Way city, Washington",35043,1963,19425,1905,15618,1946
1600000US5335275,5335275,"Kennewick city, Washington",28558,1389,18444,1532,10114,1520
1600000US5335415,5335415,"Kent city, Washington",44532,2189,23499,2109,21033,1977
1600000US5335940,5335940,"Kirkland city, Washington",34997,1481,22775,1424,12222,1339
1600000US5343955,5343955,"Marysville city, Washington",24490,1437,17325,1481,7165,1196
1600000US5353545,5353545,"Pasco city, Washington",21128,909,14751,1223,6377,1320
1600000US5357745,5357745,"Renton city, Washington",38429,2124,20067,2017,18362,1817
1600000US5363000,5363000,"Seattle city, Washington",319125,4737,147107,4200,172018,5386
1600000US5367000,5367000,"Spokane city, Washington",88076,2275,48817,2462,39259,2549
1600000US5367167,5367167,"Spokane Valley city, Washington",38744,1752,22464,2061,16280,1554
1600000US5370000,5370000,"Tacoma city, Washington",81811,3069,40185,2707,41626,2808
1600000US5374060,5374060,"Vancouver city, Washington",69845,1764,38056,1955,31789,2170
1600000US5380010,5380010,"Yakima city, Washington",33061,1724,17824,1509,15237,1640
1600000US5502375,5502375,"Appleton city, Wisconsin",28852,1423,18632,1334,10220,1431
1600000US5522300,5522300,"Eau Claire city, Wisconsin",27912,1155,15712,1196,12200,1281
1600000US5531000,5531000,"Green Bay city, Wisconsin",43285,1896,23996,1722,19289,1747
1600000US5539225,5539225,"Kenosha city, Wisconsin",38531,1286,20032,1494,18499,1439
1600000US5548000,5548000,"Madison city, Wisconsin",109549,2606,52869,2102,56680,2638
1600000US5553000,5553000,"Milwaukee city, Wisconsin",228283,3789,93184,3232,135099,4566
1600000US5560500,5560500,"Oshkosh city, Wisconsin",26655,1496,14069,1235,12586,1428
1600000US5566000,5566000,"Racine city, Wisconsin",30599,1458,14864,1335,15735,1673
1600000US5584250,5584250,"Waukesha city, Wisconsin",29102,1313,16845,1330,12257,1164
