GEO.id,GEO.id2,GEO.display-label,HD01_VD01,HD02_VD01,HD01_VD02,HD02_VD02,HD01_VD03,HD02_VD03
1600000US0107000,0107000,"Birmingham city, Alabama",88556,2920,39496,2328,49060,2647
1600000US0121184,0121184,"Dothan city, Alabama",25760,932,15149,764,10611,889
1600000US0135896,0135896,"Hoover city, Alabama",35528,1680,24295,1806,11233,1303
1600000US0137000,0137000,"Huntsville city, Alabama",79383,2468,46188,1887,33195,2148
1600000US0150000,0150000,"Mobile city, Alabama",75594,2351,41330,2186,34264,2729
1600000US0151000,0151000,"Montgomery city, Alabama",79190,1829,43476,2156,35714,2556
1600000US0177256,0177256,"Tuscaloosa city, Alabama",33487,1865,16575,1644,16912,2057
1600000US0203000,0203000,"Anchorage municipality, Alaska",104683,1844,61152,2579,43531,2743
1600000US0404720,0404720,"Avondale city, Arizona",24046,1261,12285,1424,11761,1062
1600000US0410670,0410670,"Casas Adobes CDP, Arizona",28789,2028,17826,1337,10963,1629
1600000US0412000,0412000,"Chandler city, Arizona",88216,2659,51119,2534,37097,2456
1600000US0423620,0423620,"Flagstaff city, Arizona",22669,1558,10486,1251,12183,1438
1600000US0427400,0427400,"Gilbert town, Arizona",72417,1998,50475,2573,21942,1988
1600000US0427820,0427820,"Glendale city, Arizona",77424,3061,41129,2485,36295,2603
1600000US0428380,0428380,"Goodyear city, Arizona",24655,1748,16019,1789,8636,1481
1600000US0446000,0446000,"Mesa city, Arizona",170193,4164,100543,3894,69650,3849
1600000US0454050,0454050,"Peoria city, Arizona",61466,2388,42408,3010,19058,2044
1600000US0455000,0455000,"Phoenix city, Arizona",532210,6473,270456,6358,261754,5611
1600000US0464210,0464210,"San Tan Valley CDP, Arizona",26440,1752,17276,1908,9164,1742
1600000US0465000,0465000,"Scottsdale city, Arizona",102535,3025,66566,3086,35969,2652
1600000US0471510,0471510,"Surprise city, Arizona",45919,2629,32729,2255,13190,1742
1600000US0473000,0473000,"Tempe city, Arizona",65078,2817,25502,1958,39576,2764
1600000US0477000,0477000,"Tucson city, Arizona",204262,4392,96717,3164,107545,4410
1600000US0485540,0485540,"Yuma city, Arizona",33115,1541,19386,1440,13729,1700
1600000US0523290,0523290,"Fayetteville city, Arkansas",33016,2081,13883,1429,19133,2157
1600000US0524550,0524550,"Fort Smith city, Arkansas",34200,1440,20198,1677,14002,1629
1600000US0535710,0535710,"Jonesboro city, Arkansas",27567,1427,14718,1663,12849,1841
1600000US0541000,0541000,"Little Rock city, Arkansas",77081,2480,44222,2584,32859,2995
1600000US0550450,0550450,"North Little Rock city, Arkansas",26439,1868,12965,1619,13474,1385
1600000US0566080,0566080,"Springdale city, Arkansas",25425,1610,12877,1648,12548,1506
1600000US0600562,0600562,"Alameda city, California",30574,1220,14488,1262,16086,1405
1600000US0600884,0600884,"Alhambra city, California",27880,1385,11089,1178,16791,1300
1600000US0602000,0602000,"Anaheim city, California",99402,3185,46722,2627,52680,2991
1600000US0602252,0602252,"Antioch city, California",34536,2024,20583,1902,13953,1746
1600000US0602364,0602364,"Apple Valley town, California",23822,1644,15229,1451,8593,1295
1600000US0602553,0602553,"Arden-Arcade CDP, California",40282,2399,18806,1710,21476,2267
1600000US0603526,0603526,"Bakersfield city, California",114774,2756,64655,3163,50119,3089
1600000US0603666,0603666,"Baldwin Park city, California",19153,1243,10291,1131,8862,978
1600000US0604982,0604982,"Bellflower city, California",23975,1314,9622,1201,14353,1157
1600000US0606000,0606000,"Berkeley city, California",43322,2165,17663,1282,25659,1716
1600000US0608786,0608786,"Buena Park city, California",24001,1261,12837,1437,11164,1289
1600000US0608954,0608954,"Burbank city, California",42396,1893,17000,1650,25396,1923
1600000US0610046,0610046,"Camarillo city, California",23784,1412,16248,1470,7536,1088
1600000US0611194,0611194,"Carlsbad city, California",43234,1567,27476,2243,15758,1921
1600000US0611390,0611390,"Carmichael CDP, California",27254,1850,14924,1300,12330,1797
1600000US0611530,0611530,"Carson city, California",25325,1298,18453,1615,6872,1205
1600000US0613014,0613014,"Chico city, California",35657,1970,16377,1651,19280,1799
1600000US0613210,0613210,"Chino city, California",18218,1716,11883,1320,6335,1001
1600000US0613214,0613214,"Chino Hills city, California",21940,1234,16280,1392,5660,1052
1600000US0613392,0613392,"Chula Vista city, California",78058,2684,44241,2677,33817,2762
1600000US0613588,0613588,"Citrus Heights city, California",33709,1450,18830,1749,14879,1617
1600000US0614218,0614218,"Clovis city, California",34358,1592,19226,1674,15132,1320
1600000US0615044,0615044,"Compton city, California",23763,1313,13818,1279,9945,1258
1600000US0616000,0616000,"Concord city, California",45111,2443,25567,2405,19544,1948
1600000US0616350,0616350,"Corona city, California",50041,2145,32391,1880,17650,1650
1600000US0616532,0616532,"Costa Mesa city, California",38510,2091,14843,1530,23667,1657
1600000US0617918,0617918,"Daly City city, California",29834,1730,15184,1381,14650,1485
1600000US0618100,0618100,"Davis city, California",25702,1381,10839,1038,14863,1238
1600000US0619766,0619766,"Downey city, California",34629,1839,16739,1472,17890,1775
1600000US0620802,0620802,"East Los Angeles CDP, California",31598,1511,11632,1349,19966,1679
1600000US0621712,0621712,"El Cajon city, California",31028,1567,11036,1284,19992,1481
1600000US0622020,0622020,"Elk Grove city, California",50142,2067,34219,2430,15923,1869
1600000US0622230,0622230,"El Monte city, California",30516,1292,12715,1021,17801,1454
1600000US0622804,0622804,"Escondido city, California",44612,1701,20879,1705,23733,1608
1600000US0623182,0623182,"Fairfield city, California",35360,1546,20150,1587,15210,1707
1600000US0624638,0624638,"Folsom city, California",25980,1456,17669,1317,8311,1349
1600000US0624680,0624680,"Fontana city, California",51347,2194,30408,2046,20939,1925
1600000US0626000,0626000,"Fremont city, California",73007,1811,44177,2418,28830,2135
1600000US0627000,0627000,"Fresno city, California",163875,3086,74570,3914,89305,4007
1600000US0628000,0628000,"Fullerton city, California",44648,2008,21325,1886,23323,1692
1600000US0629000,0629000,"Garden Grove city, California",46959,1894,26351,1883,20608,1535
1600000US0630000,0630000,"Glendale city, California",72163,2684,24607,1885,47556,2758
1600000US0632548,0632548,"Hawthorne city, California",31391,1699,6692,896,24699,1812
1600000US0633000,0633000,"Hayward city, California",49031,1792,25597,1647,23434,1863
1600000US0633182,0633182,"Hemet city, California",31058,2536,16746,2098,14312,1932
1600000US0633434,0633434,"Hesperia city, California",26853,1418,17650,1600,9203,1379
1600000US0636000,0636000,"Huntington Beach city, California",76357,2323,45417,2508,30940,2178
1600000US0636448,0636448,"Indio city, California",27184,1896,17879,1748,9305,1306
1600000US0636546,0636546,"Inglewood city, California",36439,1890,12379,1436,24060,1868
1600000US0636770,0636770,"Irvine city, California",90513,3320,43772,3320,46741,3349
1600000US0637692,0637692,"Jurupa Valley city, California",23734,1143,15551,1268,8183,1034
1600000US0639248,0639248,"Laguna Niguel city, California",25916,1346,19852,1430,6064,1156
1600000US0639496,0639496,"Lake Forest city, California",25428,1491,18149,1645,7279,987
1600000US0639892,0639892,"Lakewood city, California",25755,1373,18528,1375,7227,1030
1600000US0640130,0640130,"Lancaster city, California",47527,2075,26711,1968,20816,1687
1600000US0641992,0641992,"Livermore city, California",30976,1466,20580,1500,10396,1639
1600000US0643000,0643000,"Long Beach city, California",161870,3834,63817,2933,98053,3340
1600000US0644000,0644000,"Los Angeles city, California",1343084,8666,492658,8287,850426,9819
1600000US0644574,0644574,"Lynwood city, California",15577,935,5521,843,10056,1034
1600000US0645484,0645484,"Manteca city, California",23295,1879,14242,1475,9053,1246
1600000US0646842,0646842,"Menifee city, California",27000,1548,20051,1652,6949,932
1600000US0646898,0646898,"Merced city, California",26930,1169,10458,1373,16472,1400
1600000US0647766,0647766,"Milpitas city, California",21145,1214,13707,1257,7438,972
1600000US0648256,0648256,"Mission Viejo city, California",32761,1775,25716,1861,7045,1220
1600000US0648354,0648354,"Modesto city, California",71759,2433,39213,2633,32546,2406
1600000US0649270,0649270,"Moreno Valley city, California",50308,2145,28900,1963,21408,1869
1600000US0649670,0649670,"Mountain View city, California",33647,1685,13412,1261,20235,1782
1600000US0650076,0650076,"Murrieta city, California",32617,1699,21553,2001,11064,1757
1600000US0650258,0650258,"Napa city, California",29117,1131,16738,1253,12379,1297
1600000US0651182,0651182,"Newport Beach city, California",39212,1988,21492,1960,17720,2067
1600000US0652526,0652526,"Norwalk city, California",26336,1557,17785,1420,8551,1062
1600000US0653000,0653000,"Oakland city, California",156724,3502,61633,2735,95091,3372
1600000US0653322,0653322,"Oceanside city, California",62000,2265,34958,2208,27042,2329
1600000US0653896,0653896,"Ontario city, California",47375,1712,25296,2091,22079,1964
1600000US0653980,0653980,"Orange city, California",41868,1918,23149,1632,18719,1831
1600000US0654652,0654652,"Oxnard city, California",51646,2382,28692,2272,22954,1881
1600000US0655156,0655156,"Palmdale city, California",43658,1851,29420,1782,14238,1505
1600000US0655282,0655282,"Palo Alto city, California",26288,1319,15147,1260,11141,1383
1600000US0656000,0656000,"Pasadena city, California",53100,1940,22126,1481,30974,2176
1600000US0656700,0656700,"Perris city, California",16481,1181,10402,1176,6079,1215
1600000US0657456,0657456,"Pittsburg city, California",20071,1351,12407,1390,7664,1187
1600000US0657792,0657792,"Pleasanton city, California",26340,1311,17746,1333,8594,1275
1600000US0658072,0658072,"Pomona city, California",39439,1537,19439,1483,20000,1440
1600000US0659444,0659444,"Rancho Cordova city, California",24395,1252,13104,1399,11291,1230
1600000US0659451,0659451,"Rancho Cucamonga city, California",58305,2607,35221,2258,23084,2378
1600000US0659920,0659920,"Redding city, California",33424,1368,16776,1129,16648,1466
1600000US0659962,0659962,"Redlands city, California",21806,1555,11844,1484,9962,1383
1600000US0660018,0660018,"Redondo Beach city, California",26069,1556,11412,1307,14657,1598
1600000US0660102,0660102,"Redwood City city, California",29245,1662,14506,1385,14739,1348
1600000US0660466,0660466,"Rialto city, California",25834,1344,16003,1164,9831,1173
1600000US0660620,0660620,"Richmond city, California",39235,1931,17717,1578,21518,1865
1600000US0662000,0662000,"Riverside city, California",90204,2910,48317,2896,41887,2438
1600000US0662938,0662938,"Roseville city, California",48152,1593,31345,1582,16807,1548
1600000US0664000,0664000,"Sacramento city, California",177553,3506,80242,2775,97311,3506
1600000US0664224,0664224,"Salinas city, California",39390,1478,17654,1283,21736,1445
1600000US0665000,0665000,"San Bernardino city, California",54615,2403,25583,2121,29032,2172
1600000US0665042,0665042,"San Buenaventura (Ventura) city, California",42233,2064,22504,1777,19729,1821
1600000US0665084,0665084,"San Clemente city, California",24678,1334,16227,1550,8451,1483
1600000US0666000,0666000,"San Diego city, California",493446,5867,228695,5399,264751,5296
1600000US0667000,0667000,"San Francisco city, California",353406,4278,132837,4293,220569,5746
1600000US0668000,0668000,"San Jose city, California",312227,4034,178786,4571,133441,3888
1600000US0668084,0668084,"San Leandro city, California",33134,1549,17078,1653,16056,1710
1600000US0668196,0668196,"San Marcos city, California",28337,1734,16972,2068,11365,1243
1600000US0668252,0668252,"San Mateo city, California",39763,1870,21904,1872,17859,1492
1600000US0668378,0668378,"San Ramon city, California",24199,916,16676,1247,7523,1170
1600000US0669000,0669000,"Santa Ana city, California",78068,2241,35350,2115,42718,2105
1600000US0669070,0669070,"Santa Barbara city, California",35786,2175,14126,1608,21660,1929
1600000US0669084,0669084,"Santa Clara city, California",44068,1949,18249,1556,25819,1958
1600000US0669088,0669088,"Santa Clarita city, California",58505,1683,38906,1969,19599,1640
1600000US0669196,0669196,"Santa Maria city, California",26846,1458,13024,1469,13822,1422
1600000US0670000,0670000,"Santa Monica city, California",46474,2081,13102,1333,33372,2009
1600000US0670098,0670098,"Santa Rosa city, California",65282,2450,34829,2383,30453,2227
1600000US0672016,0672016,"Simi Valley city, California",42595,1638,29725,1760,12870,1401
1600000US0673080,0673080,"South Gate city, California",23254,1017,9880,977,13374,1185
1600000US0673262,0673262,"South San Francisco city, California",22319,1544,13495,1406,8824,1424
1600000US0675000,0675000,"Stockton city, California",95166,2335,42962,2632,52204,2301
1600000US0677000,0677000,"Sunnyvale city, California",54473,1901,25441,1941,29032,2072
1600000US0678120,0678120,"Temecula city, California",33643,1595,22755,1592,10888,1392
1600000US0678582,0678582,"Thousand Oaks city, California",45863,1594,32716,1906,13147,1552
1600000US0680000,0680000,"Torrance city, California",53971,2205,28761,2192,25210,1769
1600000US0680238,0680238,"Tracy city, California",23424,1318,14160,1537,9264,1324
1600000US0680812,0680812,"Turlock city, California",24667,1383,12278,1498,12389,1457
1600000US0680854,0680854,"Tustin city, California",26426,1559,13142,1210,13284,1357
1600000US0681204,0681204,"Union City city, California",20605,1157,13030,1183,7575,876
1600000US0681344,0681344,"Upland city, California",28151,1501,14972,1349,13179,1297
1600000US0681554,0681554,"Vacaville city, California",32430,1344,19320,1472,13110,1601
1600000US0681666,0681666,"Vallejo city, California",41802,1718,21668,1612,20134,1371
1600000US0682590,0682590,"Victorville city, California",31716,2456,17133,2590,14583,1913
1600000US0682954,0682954,"Visalia city, California",41367,2266,25495,2563,15872,2003
1600000US0682996,0682996,"Vista city, California",29165,1549,13943,1425,15222,1565
1600000US0683346,0683346,"Walnut Creek city, California",31515,1570,18954,1717,12561,1500
1600000US0684200,0684200,"West Covina city, California",30607,1421,20612,1558,9995,979
1600000US0684550,0684550,"Westminster city, California",28260,1365,14199,1163,14061,1355
1600000US0685292,0685292,"Whittier city, California",26240,1475,15243,1307,10997,1185
1600000US0686832,0686832,"Yorba Linda city, California",21052,1069,16795,1342,4257,902
1600000US0686972,0686972,"Yuba City city, California",22264,987,12558,1329,9706,1191
1600000US0803455,0803455,"Arvada city, Colorado",43588,1539,31260,1544,12328,1486
1600000US0804000,0804000,"Aurora city, Colorado",126677,2318,71380,2558,55297,2316
1600000US0807850,0807850,"Boulder city, Colorado",44059,1703,21284,1593,22775,1714
1600000US0812815,0812815,"Centennial city, Colorado",39055,1289,33362,1507,5693,858
1600000US0816000,0816000,"Colorado Springs city, Colorado",174943,2905,104609,3278,70334,3216
1600000US0820000,0820000,"Denver city, Colorado",281928,3071,135736,3471,146192,4056
1600000US0827425,0827425,"Fort Collins city, Colorado",57064,2186,30076,1839,26988,2029
1600000US0832155,0832155,"Greeley city, Colorado",33714,1630,19843,1572,13871,1416
1600000US0836410,0836410,"Highlands Ranch CDP, Colorado",34831,1334,28145,1479,6686,1084
1600000US0843000,0843000,"Lakewood city, Colorado",65127,1917,36489,2119,28638,1800
1600000US0845970,0845970,"Longmont city, Colorado",33314,1655,20340,1445,12974,1299
1600000US0846465,0846465,"Loveland city, Colorado",31579,1466,18799,1461,12780,1558
1600000US0862000,0862000,"Pueblo city, Colorado",42859,1606,23965,1567,18894,1648
1600000US0877290,0877290,"Thornton city, Colorado",42725,1982,28172,1894,14553,1529
1600000US0883835,0883835,"Westminster city, Colorado",43731,1602,27582,1670,16149,1355
1600000US0908000,0908000,"Bridgeport city, Connecticut",49779,2306,20178,1594,29601,2265
1600000US0918430,0918430,"Danbury city, Connecticut",28524,1475,16371,1411,12153,1217
1600000US0937000,0937000,"Hartford city, Connecticut",44740,2231,10517,1252,34223,2036
1600000US0950370,0950370,"New Britain city, Connecticut",27764,1353,11238,1026,16526,1316
1600000US0952000,0952000,"New Haven city, Connecticut",49281,2198,13970,1581,35311,2302
1600000US0955990,0955990,"Norwalk city, Connecticut",33461,1637,19720,1492,13741,1546
1600000US0973000,0973000,"Stamford city, Connecticut",49377,2404,27739,2055,21638,2143
1600000US0980000,0980000,"Waterbury city, Connecticut",39608,2078,17305,1672,22303,1871
1600000US1077580,1077580,"Wilmington city, Delaware",29969,1625,14480,1323,15489,1514
1600000US1150000,1150000,"Washington city, District of Columbia",277378,3304,112492,3641,164886,4965
1600000US1200410,1200410,"Alafaya CDP, Florida",27479,2949,15358,2443,12121,2771
1600000US1207300,1207300,"Boca Raton city, Florida",35995,2099,24705,2098,11290,1423
1600000US1207875,1207875,"Boynton Beach city, Florida",28361,2066,17015,1702,11346,1414
1600000US1208150,1208150,"Brandon CDP, Florida",40044,2503,21926,1660,18118,2042
1600000US1210275,1210275,"Cape Coral city, Florida",64329,2491,43181,2392,21148,2241
1600000US1212875,1212875,"Clearwater city, Florida",46053,2525,26077,2209,19976,1870
1600000US1214400,1214400,"Coral Springs city, Florida",40278,1596,24701,1936,15577,1468
1600000US1216475,1216475,"Davie town, Florida",33209,1677,23397,1993,9812,1499
1600000US1216725,1216725,"Deerfield Beach city, Florida",30923,2183,17780,1955,13143,1580
1600000US1217100,1217100,"Delray Beach city, Florida",26774,1791,15828,1720,10946,1442
1600000US1217200,1217200,"Deltona city, Florida",29801,1990,21328,2182,8473,1403
1600000US1224000,1224000,"Fort Lauderdale city, Florida",75205,2845,39223,2415,35982,2634
1600000US1224125,1224125,"Fort Myers city, Florida",26571,1803,12904,1561,13667,1587
1600000US1225175,1225175,"Gainesville city, Florida",49098,2576,19549,2091,29549,2517
1600000US1230000,1230000,"Hialeah city, Florida",68027,2566,30007,2244,38020,2142
1600000US1232000,1232000,"Hollywood city, Florida",56965,2577,31857,2560,25108,1906
1600000US1232275,1232275,"Homestead city, Florida",19025,1892,6596,1560,12429,1852
1600000US1235000,1235000,"Jacksonville city, Florida",320809,5400,178353,4770,142456,5491
1600000US1236100,1236100,"Kendall CDP, Florida",29517,2229,18539,1873,10978,1703
1600000US1236950,1236950,"Kissimmee city, Florida",20172,1766,7965,1388,12207,1339
1600000US1238250,1238250,"Lakeland city, Florida",38052,2021,20721,1887,17331,1540
1600000US1239425,1239425,"Largo city, Florida",36179,2200,19085,1665,17094,1706
1600000US1239550,1239550,"Lauderhill city, Florida",23073,1564,12861,1577,10212,1260
1600000US1239925,1239925,"Lehigh Acres CDP, Florida",32416,2104,17318,1607,15098,1572
1600000US1243975,1243975,"Melbourne city, Florida",33573,1849,19267,1802,14306,2120
1600000US1245000,1245000,"Miami city, Florida",158039,4485,46018,2750,112021,4090
1600000US1245025,1245025,"Miami Beach city, Florida",41959,2137,16136,1392,25823,1964
1600000US1245060,1245060,"Miami Gardens city, Florida",30786,1976,20114,1615,10672,1643
1600000US1245975,1245975,"Miramar city, Florida",36377,1855,26829,2102,9548,1614
1600000US1253000,1253000,"Orlando city, Florida",109685,3711,37733,2977,71952,3760
1600000US1254000,1254000,"Palm Bay city, Florida",37241,1910,25454,2079,11787,1763
1600000US1254200,1254200,"Palm Coast city, Florida",28925,1617,21624,1460,7301,1138
1600000US1255775,1255775,"Pembroke Pines city, Florida",54927,2432,41337,2640,13590,2013
1600000US1256825,1256825,"Pine Hills CDP, Florida",21874,1979,11364,1378,10510,1378
1600000US1257425,1257425,"Plantation city, Florida",34058,1759,20108,1700,13950,1343
1600000US1258050,1258050,"Pompano Beach city, Florida",43307,2413,22299,2038,21008,2186
1600000US1258715,1258715,"Port St. Lucie city, Florida",63557,3123,50025,3416,13532,2463
1600000US1260950,1260950,"Riverview CDP, Florida",27865,2115,19435,1772,8430,1568
1600000US1263000,1263000,"St. Petersburg city, Florida",103519,3325,57445,3426,46074,3086
1600000US1268350,1268350,"Spring Hill CDP, Florida",39055,2133,29918,2020,9137,1342
1600000US1269700,1269700,"Sunrise city, Florida",30491,1838,20432,1818,10059,1372
1600000US1270600,1270600,"Tallahassee city, Florida",75056,2331,27568,1785,47488,2418
1600000US1271000,1271000,"Tampa city, Florida",140429,3251,67526,3124,72903,3401
1600000US1271625,1271625,"The Villages CDP, Florida",37418,1912,35468,1662,1950,1172
1600000US1272145,1272145,"Town 'n' Country CDP, Florida",31621,2362,17224,1657,14397,2042
1600000US1276582,1276582,"Weston city, Florida",22030,1240,15976,1583,6054,1275
1600000US1276600,1276600,"West Palm Beach city, Florida",42349,2204,19186,1699,23163,1859
1600000US1301052,1301052,"Albany city, Georgia",28248,1391,10803,1160,17445,1437
1600000US1303440,1303440,"Athens-Clarke County unified government (balance), Georgia",43568,1907,14156,1270,29412,1805
1600000US1304000,1304000,"Atlanta city, Georgia",189431,4283,83432,3471,105999,4608
1600000US1304204,1304204,"Augusta-Richmond County consolidated government (balance), Georgia",69436,2427,35046,2553,34390,2572
1600000US1319000,1319000,"Columbus city, Georgia",74339,2252,35771,1845,38568,2074
1600000US1342425,1342425,"Johns Creek city, Georgia",28014,2236,20854,2300,7160,1292
1600000US1349008,1349008,"Macon-Bibb County, Georgia",56052,1769,28881,1747,27171,1880
1600000US1367284,1367284,"Roswell city, Georgia",34288,1873,22077,1866,12211,1615
1600000US1368516,1368516,"Sandy Springs city, Georgia",44822,2670,20830,1870,23992,2255
1600000US1369000,1369000,"Savannah city, Georgia",54628,2060,24168,1800,30460,2018
1600000US1380508,1380508,"Warner Robins city, Georgia",27331,1905,15418,1546,11913,1701
1600000US1571550,1571550,"Urban Honolulu CDP, Hawaii",127394,2640,56292,2276,71102,2700
1600000US1608830,1608830,"Boise City city, Idaho",84511,2667,49120,2591,35391,2877
1600000US1652120,1652120,"Meridian city, Idaho",31969,2092,24933,2251,7036,1509
1600000US1656260,1656260,"Nampa city, Idaho",29806,1414,17376,1686,12430,1699
1600000US1702154,1702154,"Arlington Heights village, Illinois",30184,1489,21695,1554,8489,1261
1600000US1703012,1703012,"Aurora city, Illinois",59547,2670,38476,2557,21071,2111
1600000US1706613,1706613,"Bloomington city, Illinois",31373,1248,18891,1320,12482,1241
1600000US1707133,1707133,"Bolingbrook village, Illinois",22024,1176,16681,1354,5343,1112
1600000US1712385,1712385,"Champaign city, Illinois",33606,1778,16634,1345,16972,1562
1600000US1714000,1714000,"Chicago city, Illinois",1031672,8449,450277,7054,581395,7679
1600000US1714351,1714351,"Cicero town, Illinois",22169,1231,10726,1082,11443,1401
1600000US1718823,1718823,"Decatur city, Illinois",30237,1467,19562,1252,10675,1135
1600000US1723074,1723074,"Elgin city, Illinois",37537,2357,24133,2285,13404,1855
1600000US1724582,1724582,"Evanston city, Illinois",28577,1627,15896,1299,12681,1250
1600000US1738570,1738570,"Joliet city, Illinois",47219,1960,32600,2103,14619,1529
1600000US1751622,1751622,"Naperville city, Illinois",51165,1472,38446,1576,12719,1156
1600000US1757225,1757225,"Palatine village, Illinois",26957,1643,18423,1524,8534,1086
1600000US1759000,1759000,"Peoria city, Illinois",47432,1888,27337,1786,20095,1692
1600000US1765000,1765000,"Rockford city, Illinois",59772,1819,32353,1602,27419,1845
1600000US1768003,1768003,"Schaumburg village, Illinois",30457,1636,17941,1600,12516,1558
1600000US1770122,1770122,"Skokie village, Illinois",21428,1421,15514,1429,5914,1164
1600000US1772000,1772000,"Springfield city, Illinois",50157,1689,30172,1780,19985,1701
1600000US1779293,1779293,"Waukegan city, Illinois",28445,1729,13053,1353,15392,1612
1600000US1805860,1805860,"Bloomington city, Indiana",29984,2071,10257,1253,19727,2016
1600000US1810342,1810342,"Carmel city, Indiana",32573,1248,26384,1365,6189,997
1600000US1822000,1822000,"Evansville city, Indiana",51287,1872,27350,1859,23937,1989
1600000US1823278,1823278,"Fishers town, Indiana",30195,1499,23240,1555,6955,1462
1600000US1825000,1825000,"Fort Wayne city, Indiana",100239,2516,61562,2422,38677,2036
1600000US1827000,1827000,"Gary city, Indiana",28078,1524,13946,1280,14132,1248
1600000US1831000,1831000,"Hammond city, Indiana",28168,1478,16822,1396,11346,1403
1600000US1836003,1836003,"Indianapolis city (balance), Indiana",328526,4886,176963,3828,151563,4627
1600000US1840788,1840788,"Lafayette city, Indiana",27331,1459,12884,1074,14447,1404
1600000US1851876,1851876,"Muncie city, Indiana",26981,1444,14012,1217,12969,1379
1600000US1871000,1871000,"South Bend city, Indiana",40677,2129,22790,1758,17887,1454
1600000US1912000,1912000,"Cedar Rapids city, Iowa",53672,1760,38212,2082,15460,1853
1600000US1919000,1919000,"Davenport city, Iowa",40657,1194,24632,1567,16025,1403
1600000US1921000,1921000,"Des Moines city, Iowa",81779,2070,46466,2518,35313,2261
1600000US1938595,1938595,"Iowa City city, Iowa",29824,1426,15268,1477,14556,1695
1600000US1973335,1973335,"Sioux City city, Iowa",31220,979,18561,1444,12659,1387
1600000US1982425,1982425,"Waterloo city, Iowa",29169,1207,18641,1131,10528,1297
1600000US2036000,2036000,"Kansas City city, Kansas",55680,1105,31141,1277,24539,1461
1600000US2038900,2038900,"Lawrence city, Kansas",36264,1455,16826,1374,19438,1619
1600000US2052575,2052575,"Olathe city, Kansas",45063,1498,30381,1581,14682,1445
1600000US2053775,2053775,"Overland Park city, Kansas",75459,2096,48512,2005,26947,1825
1600000US2071000,2071000,"Topeka city, Kansas",51318,1572,29763,1642,21555,1892
1600000US2079000,2079000,"Wichita city, Kansas",149920,2997,90930,2469,58990,2584
1600000US2146027,2146027,"Lexington-Fayette urban county, Kentucky",127412,1883,68508,2185,58904,2555
1600000US2148006,2148006,"Louisville/Jefferson County metro government (balance), Kentucky",244583,4000,145819,3926,98764,3752
1600000US2205000,2205000,"Baton Rouge city, Louisiana",91034,2417,43004,2210,48030,2721
1600000US2208920,2208920,"Bossier City city, Louisiana",24869,1322,12359,1449,12510,1363
1600000US2239475,2239475,"Kenner city, Louisiana",25553,1379,15443,1486,10110,1439
1600000US2240735,2240735,"Lafayette city, Louisiana",49939,2268,25868,1981,24071,2154
1600000US2241155,2241155,"Lake Charles city, Louisiana",30751,1677,15110,1750,15641,1728
1600000US2250115,2250115,"Metairie CDP, Louisiana",59799,2457,37466,1924,22333,1877
1600000US2255000,2255000,"New Orleans city, Louisiana",152788,2802,70108,2547,82680,2557
1600000US2270000,2270000,"Shreveport city, Louisiana",74512,2374,40052,2141,34460,2513
1600000US2360545,2360545,"Portland city, Maine",30023,1514,13343,1358,16680,1229
1600000US2404000,2404000,"Baltimore city, Maryland",238897,3190,109782,3324,129115,3648
1600000US2407125,2407125,"Bethesda CDP, Maryland",24905,1030,17088,796,7817,970
1600000US2419125,2419125,"Columbia CDP, Maryland",38493,1826,25891,1536,12602,1643
1600000US2426000,2426000,"Ellicott City CDP, Maryland",25584,1556,18664,1329,6920,1191
1600000US2430325,2430325,"Frederick city, Maryland",27209,1428,15276,1635,11933,1604
1600000US2431175,2431175,"Gaithersburg city, Maryland",22988,1629,10986,1473,12002,1341
1600000US2432025,2432025,"Germantown CDP, Maryland",30075,1822,20819,1636,9256,1644
1600000US2432650,2432650,"Glen Burnie CDP, Maryland",26247,2006,15032,1466,11215,1810
1600000US2467675,2467675,"Rockville city, Maryland",25545,1637,14553,1444,10992,1174
1600000US2472450,2472450,"Silver Spring CDP, Maryland",31374,1910,11386,1127,19988,1785
1600000US2481175,2481175,"Waldorf CDP, Maryland",24932,1272,16529,1472,8403,1182
1600000US2507000,2507000,"Boston city, Massachusetts",253749,3479,88610,3625,165139,3823
1600000US2509000,2509000,"Brockton city, Massachusetts",33006,1642,16549,1442,16457,1485
1600000US2511000,2511000,"Cambridge city, Massachusetts",43058,1836,15501,1379,27557,1749
1600000US2523000,2523000,"Fall River city, Massachusetts",39121,1658,13386,1443,25735,1927
1600000US2524960,2524960,"Framingham CDP, Massachusetts",26770,1499,15485,1582,11285,1418
1600000US2534550,2534550,"Lawrence city, Massachusetts",25613,1473,6842,1109,18771,1417
1600000US2537000,2537000,"Lowell city, Massachusetts",38173,2144,16863,1508,21310,1908
1600000US2537490,2537490,"Lynn city, Massachusetts",32235,1744,14521,1487,17714,1616
1600000US2545000,2545000,"New Bedford city, Massachusetts",38046,1498,15151,1406,22895,1660
1600000US2545560,2545560,"Newton city, Massachusetts",31595,1168,22114,1184,9481,1022
1600000US2555745,2555745,"Quincy city, Massachusetts",40083,1706,18687,1367,21396,1900
1600000US2562535,2562535,"Somerville city, Massachusetts",31566,1931,9977,1277,21589,1710
1600000US2567000,2567000,"Springfield city, Massachusetts",55816,1844,24984,1743,30832,1700
1600000US2582000,2582000,"Worcester city, Massachusetts",64923,2562,26660,1779,38263,2373
1600000US2603000,2603000,"Ann Arbor city, Michigan",46326,1779,20455,1496,25871,1585
1600000US2621000,2621000,"Dearborn city, Michigan",31827,1348,20045,1160,11782,1087
1600000US2622000,2622000,"Detroit city, Michigan",253490,3816,117245,3831,136245,3529
1600000US2627440,2627440,"Farmington Hills city, Michigan",34613,1546,21426,1251,13187,1450
1600000US2629000,2629000,"Flint city, Michigan",39125,1659,19664,1697,19461,1770
1600000US2634000,2634000,"Grand Rapids city, Michigan",72388,2375,36388,2006,36000,2689
1600000US2642160,2642160,"Kalamazoo city, Michigan",28996,1501,11916,1256,17080,1446
1600000US2646000,2646000,"Lansing city, Michigan",47908,1709,24968,1598,22940,1564
1600000US2649000,2649000,"Livonia city, Michigan",35937,1487,29908,1621,6029,931
1600000US2669035,2669035,"Rochester Hills city, Michigan",27668,1119,20594,1413,7074,1091
1600000US2674900,2674900,"Southfield city, Michigan",33860,1694,16472,1475,17388,1688
1600000US2676460,2676460,"Sterling Heights city, Michigan",49635,1766,34621,2159,15014,1962
1600000US2680700,2680700,"Troy city, Michigan",30597,1039,22173,1048,8424,1028
1600000US2684000,2684000,"Warren city, Michigan",53403,1882,36672,2285,16731,1880
1600000US2686000,2686000,"Westland city, Michigan",34251,1593,19607,1502,14644,1416
1600000US2688940,2688940,"Wyoming city, Michigan",27786,1604,17647,1420,10139,1376
1600000US2706616,2706616,"Bloomington city, Minnesota",37593,1943,25706,1579,11887,1310
1600000US2707966,2707966,"Brooklyn Park city, Minnesota",26544,1851,18724,1830,7820,1229
1600000US2717000,2717000,"Duluth city, Minnesota",36307,1491,21210,1101,15097,1267
1600000US2717288,2717288,"Eagan city, Minnesota",27007,1085,18555,1152,8452,981
1600000US2740166,2740166,"Maple Grove city, Minnesota",27457,1259,22628,1395,4829,952
1600000US2743000,2743000,"Minneapolis city, Minnesota",169306,3704,80777,3162,88529,3157
1600000US2751730,2751730,"Plymouth city, Minnesota",29678,1630,20838,1586,8840,1197
1600000US2754880,2754880,"Rochester city, Minnesota",44661,1030,30679,1467,13982,1463
1600000US2756896,2756896,"St. Cloud city, Minnesota",25421,1366,14546,1357,10875,1410
1600000US2758000,2758000,"St. Paul city, Minnesota",110978,2404,52428,2287,58550,2469
1600000US2771428,2771428,"Woodbury city, Minnesota",26101,1184,19846,1329,6255,1144
1600000US2829700,2829700,"Gulfport city, Mississippi",30048,1533,15674,1746,14374,1532
1600000US2836000,2836000,"Jackson city, Mississippi",62679,2003,32363,2372,30316,2354
1600000US2915670,2915670,"Columbia city, Missouri",45405,1903,21561,1768,23844,2094
1600000US2935000,2935000,"Independence city, Missouri",47145,1936,29417,2012,17728,1877
1600000US2938000,2938000,"Kansas City city, Missouri",195125,4085,102216,3542,92909,3475
1600000US2941348,2941348,"Lee's Summit city, Missouri",34259,1434,26708,1590,7551,1325
1600000US2954074,2954074,"O'Fallon city, Missouri",29689,1298,23960,1382,5729,1020
1600000US2964082,2964082,"St. Charles city, Missouri",27104,1362,17483,1456,9621,1322
1600000US2964550,2964550,"St. Joseph city, Missouri",28421,1143,16441,1305,11980,1252
1600000US2965000,2965000,"St. Louis city, Missouri",137784,2738,58554,2691,79230,3464
1600000US2970000,2970000,"Springfield city, Missouri",69761,2241,32859,1915,36902,2443
1600000US3006550,3006550,"Billings city, Montana",43498,1284,27164,1629,16334,1722
1600000US3050200,3050200,"Missoula city, Montana",30054,1359,15066,1378,14988,1675
1600000US3128000,3128000,"Lincoln city, Nebraska",108954,1670,62333,2027,46621,1851
1600000US3137000,3137000,"Omaha city, Nebraska",174747,2535,98688,2635,76059,2957
1600000US3223770,3223770,"Enterprise CDP, Nevada",42332,2897,23103,2292,19229,1920
1600000US3231900,3231900,"Henderson city, Nevada",107007,3236,62505,3067,44502,2808
1600000US3240000,3240000,"Las Vegas city, Nevada",212742,4463,104255,4373,108487,4416
1600000US3251800,3251800,"North Las Vegas city, Nevada",72412,2760,39685,2592,32727,2528
1600000US3254600,3254600,"Paradise CDP, Nevada",91155,3514,35721,2513,55434,2667
1600000US3260600,3260600,"Reno city, Nevada",92608,2502,43421,2608,49187,2272
1600000US3268400,3268400,"Sparks city, Nevada",35785,1619,20332,1725,15453,1487
1600000US3268585,3268585,"Spring Valley CDP, Nevada",71724,3328,32787,2160,38937,2924
1600000US3271400,3271400,"Sunrise Manor CDP, Nevada",60506,3094,27277,1900,33229,2756
1600000US3345140,3345140,"Manchester city, New Hampshire",44156,1983,21684,1618,22472,1734
1600000US3350260,3350260,"Nashua city, New Hampshire",34864,1615,19761,1455,15103,1529
1600000US3403580,3403580,"Bayonne city, New Jersey",24733,1361,8475,1040,16258,1447
1600000US3410000,3410000,"Camden city, New Jersey",26396,1691,10889,1675,15507,1543
1600000US3413690,3413690,"Clifton city, New Jersey",29065,1621,16721,1488,12344,1598
1600000US3419390,3419390,"East Orange city, New Jersey",25913,1581,6239,856,19674,1473
1600000US3421000,3421000,"Elizabeth city, New Jersey",39546,2004,9793,1398,29753,1850
1600000US3436000,3436000,"Jersey City city, New Jersey",98873,2550,27969,2293,70904,2796
1600000US3451000,3451000,"Newark city, New Jersey",89182,2731,20818,1627,68364,2545
1600000US3456550,3456550,"Passaic city, New Jersey",18813,1289,4228,892,14585,1344
1600000US3457000,3457000,"Paterson city, New Jersey",42318,2001,11482,1192,30836,2002
1600000US3473110,3473110,"Toms River CDP, New Jersey",32937,1687,26866,1827,6071,1069
1600000US3474000,3474000,"Trenton city, New Jersey",28185,1582,9465,992,18720,1353
1600000US3474630,3474630,"Union City city, New Jersey",24707,1319,4089,719,20618,1403
1600000US3502000,3502000,"Albuquerque city, New Mexico",219867,3905,127142,3950,92725,4222
1600000US3539380,3539380,"Las Cruces city, New Mexico",40668,1652,20925,1871,19743,2120
1600000US3563460,3563460,"Rio Rancho city, New Mexico",33530,1143,26450,1598,7080,1322
1600000US3570500,3570500,"Santa Fe city, New Mexico",31001,1521,18156,1448,12845,1619
1600000US3601000,3601000,"Albany city, New York",41262,2095,14933,1395,26329,1892
1600000US3608026,3608026,"Brentwood CDP, New York",14780,1310,10621,1270,4159,975
1600000US3611000,3611000,"Buffalo city, New York",110070,3145,44396,2773,65674,3082
1600000US3615000,3615000,"Cheektowaga CDP, New York",34471,1623,24357,1769,10114,1203
1600000US3649121,3649121,"Mount Vernon city, New York",24538,1405,9666,1108,14872,1229
1600000US3650617,3650617,"New Rochelle city, New York",27841,1391,13626,1093,14215,1518
1600000US3651000,3651000,"New York city, New York",3148067,10464,981565,12911,2166502,15568
1600000US3663000,3663000,"Rochester city, New York",83944,3035,30610,2094,53334,2876
1600000US3665508,3665508,"Schenectady city, New York",24127,1669,11954,1267,12173,1594
1600000US3673000,3673000,"Syracuse city, New York",54712,2140,20698,1454,34014,1886
1600000US3684000,3684000,"Yonkers city, New York",74187,2660,35540,2311,38647,2394
1600000US3702140,3702140,"Asheville city, North Carolina",39930,2300,20430,1861,19500,2273
1600000US3710740,3710740,"Cary town, North Carolina",56738,1999,39954,1923,16784,1692
1600000US3712000,3712000,"Charlotte city, North Carolina",310106,3723,164412,4090,145694,3702
1600000US3714100,3714100,"Concord city, North Carolina",30591,1402,19765,1557,10826,1527
1600000US3719000,3719000,"Durham city, North Carolina",104830,2176,50124,2390,54706,2971
1600000US3722920,3722920,"Fayetteville city, North Carolina",79637,2028,36639,1605,42998,1982
1600000US3725580,3725580,"Gastonia city, North Carolina",28187,1307,16153,1163,12034,1107
1600000US3728000,3728000,"Greensboro city, North Carolina",113350,3074,54296,2782,59054,3019
1600000US3728080,3728080,"Greenville city, North Carolina",37752,1547,13448,1577,24304,1715
1600000US3731400,3731400,"High Point city, North Carolina",38948,2150,21262,1748,17686,1522
1600000US3734200,3734200,"Jacksonville city, North Carolina",20741,1735,6563,1308,14178,1973
1600000US3755000,3755000,"Raleigh city, North Carolina",173456,3979,85116,3557,88340,4376
1600000US3774440,3774440,"Wilmington city, North Carolina",49459,2321,21698,1713,27761,1873
1600000US3775000,3775000,"Winston-Salem city, North Carolina",95771,2159,50026,2612,45745,2346
1600000US3807200,3807200,"Bismarck city, North Dakota",30704,1083,18929,1223,11775,1422
1600000US3825700,3825700,"Fargo city, North Dakota",50430,1909,22815,1721,27615,2359
1600000US3901000,3901000,"Akron city, Ohio",83604,2573,43510,2462,40094,2311
1600000US3912000,3912000,"Canton city, Ohio",29075,1601,14460,1277,14615,1418
1600000US3915000,3915000,"Cincinnati city, Ohio",137197,3365,49314,2442,87883,3310
1600000US3916000,3916000,"Cleveland city, Ohio",165984,3538,65592,3074,100392,2993
1600000US3918000,3918000,"Columbus city, Ohio",339145,4732,149543,4106,189602,4598
1600000US3921000,3921000,"Dayton city, Ohio",56251,2141,27083,1896,29168,1883
1600000US3944856,3944856,"Lorain city, Ohio",24321,1439,13411,1289,10910,1260
1600000US3961000,3961000,"Parma city, Ohio",33940,1484,24356,1400,9584,1329
1600000US3977000,3977000,"Toledo city, Ohio",116450,2649,61797,2891,54653,2586
1600000US3988000,3988000,"Youngstown city, Ohio",26934,1541,14662,1289,12272,1309
1600000US4009050,4009050,"Broken Arrow city, Oklahoma",37813,1102,28062,1129,9751,1051
1600000US4023200,4023200,"Edmond city, Oklahoma",32977,1415,23355,1588,9622,1183
1600000US4041850,4041850,"Lawton city, Oklahoma",32315,1791,15869,1457,16446,2077
1600000US4052500,4052500,"Norman city, Oklahoma",45454,2074,25024,1763,20430,1930
1600000US4055000,4055000,"Oklahoma City city, Oklahoma",237213,3527,135188,3474,102025,3678
1600000US4075000,4075000,"Tulsa city, Oklahoma",165817,2112,86251,2195,79566,2556
1600000US4105350,4105350,"Beaverton city, Oregon",38807,2169,17981,1843,20826,1829
1600000US4105800,4105800,"Bend city, Oregon",33526,1850,19829,2018,13697,1761
1600000US4123850,4123850,"Eugene city, Oregon",64345,1848,31699,1824,32646,1690
1600000US4131250,4131250,"Gresham city, Oregon",38393,1941,18599,1570,19794,1585
1600000US4134100,4134100,"Hillsboro city, Oregon",37134,1629,18604,1316,18530,1612
1600000US4147000,4147000,"Medford city, Oregon",30122,1694,16460,1524,13662,1514
1600000US4159000,4159000,"Portland city, Oregon",257267,3136,132248,3854,125019,4004
1600000US4164900,4164900,"Salem city, Oregon",58793,2212,31889,1947,26904,1882
1600000US4202000,4202000,"Allentown city, Pennsylvania",40275,1748,18048,1565,22227,1390
1600000US4206088,4206088,"Bethlehem city, Pennsylvania",30474,1526,14603,1411,15871,1602
1600000US4224000,4224000,"Erie city, Pennsylvania",40433,1457,20653,1473,19780,1623
1600000US4260000,4260000,"Philadelphia city, Pennsylvania",577862,5809,300561,6655,277301,7122
1600000US4261000,4261000,"Pittsburgh city, Pennsylvania",131112,3346,62007,2400,69105,3096
1600000US4263624,4263624,"Reading city, Pennsylvania",29942,1687,12163,1296,17779,1438
1600000US4269000,4269000,"Scranton city, Pennsylvania",27886,1350,14760,955,13126,1261
1600000US4419180,4419180,"Cranston city, Rhode Island",31653,1719,21143,1508,10510,1634
1600000US4454640,4454640,"Pawtucket city, Rhode Island",26336,1165,10907,1169,15429,1189
1600000US4459000,4459000,"Providence city, Rhode Island",62020,2172,19248,2013,42772,2230
1600000US4474300,4474300,"Warwick city, Rhode Island",33887,1098,24000,1280,9887,1267
1600000US4513330,4513330,"Charleston city, South Carolina",54144,2214,26932,1890,27212,1944
1600000US4516000,4516000,"Columbia city, South Carolina",45297,2669,19639,1602,25658,2208
1600000US4548535,4548535,"Mount Pleasant town, South Carolina",31215,1746,22116,1964,9099,1441
1600000US4550875,4550875,"North Charleston city, South Carolina",40977,2001,17312,1673,23665,1859
1600000US4561405,4561405,"Rock Hill city, South Carolina",26841,1364,13643,1324,13198,1310
1600000US4652980,4652980,"Rapid City city, South Dakota",28494,1274,16294,1330,12200,1255
1600000US4659020,4659020,"Sioux Falls city, South Dakota",67005,1532,40684,1788,26321,1667
1600000US4714000,4714000,"Chattanooga city, Tennessee",70382,2292,35603,2200,34779,2380
1600000US4715160,4715160,"Clarksville city, Tennessee",51617,1637,28089,1716,23528,1827
1600000US4727740,4727740,"Franklin city, Tennessee",25725,1153,18159,1289,7566,1270
1600000US4737640,4737640,"Jackson city, Tennessee",25948,1112,14094,1371,11854,1332
1600000US4738320,4738320,"Johnson City city, Tennessee",28059,1600,15588,1317,12471,1475
1600000US4740000,4740000,"Knoxville city, Tennessee",77502,2469,34622,1963,42880,2553
1600000US4748000,4748000,"Memphis city, Tennessee",250553,3753,119076,4245,131477,3999
1600000US4751560,4751560,"Murfreesboro city, Tennessee",46058,2124,22943,1948,23115,1945
1600000US4752006,4752006,"Nashville-Davidson metropolitan government (balance), Tennessee",258263,3494,135282,4133,122981,3773
1600000US4801000,4801000,"Abilene city, Texas",41710,1745,21966,1535,19744,1575
1600000US4801924,4801924,"Allen city, Texas",30341,1521,23515,1653,6826,1300
1600000US4803000,4803000,"Amarillo city, Texas",74709,1755,45807,2084,28902,1941
1600000US4804000,4804000,"Arlington city, Texas",135093,3965,72842,3521,62251,3340
1600000US4804462,4804462,"Atascocita CDP, Texas",22899,2191,18451,1897,4448,1278
1600000US4805000,4805000,"Austin city, Texas",360996,4783,161402,4342,199594,5140
1600000US4806128,4806128,"Baytown city, Texas",27073,1795,15195,1834,11878,1596
1600000US4807000,4807000,"Beaumont city, Texas",45669,1991,25867,1778,19802,2051
1600000US4810768,4810768,"Brownsville city, Texas",50340,1855,31359,1878,18981,1906
1600000US4810912,4810912,"Bryan city, Texas",29718,1785,13676,1473,16042,1646
1600000US4813024,4813024,"Carrollton city, Texas",45936,1836,26707,1646,19229,2085
1600000US4815976,4815976,"College Station city, Texas",38725,1766,12598,1228,26127,1841
1600000US4816432,4816432,"Conroe city, Texas",23105,2238,11537,1542,11568,1912
1600000US4817000,4817000,"Corpus Christi city, Texas",117685,2279,66577,2771,51108,2853
1600000US4819000,4819000,"Dallas city, Texas",484335,6075,199532,4759,284803,6071
1600000US4819972,4819972,"Denton city, Texas",46295,2105,21427,1786,24868,2138
1600000US4822660,4822660,"Edinburg city, Texas",23471,1700,12257,1533,11214,1810
1600000US4824000,4824000,"El Paso city, Texas",218127,3208,129034,3522,89093,3327
1600000US4826232,4826232,"Flower Mound town, Texas",21963,852,19452,958,2511,728
1600000US4827000,4827000,"Fort Worth city, Texas",281924,4487,157225,5481,124699,5247
1600000US4827684,4827684,"Frisco city, Texas",47880,1220,36567,1348,11313,1300
1600000US4829000,4829000,"Garland city, Texas",75775,2182,48041,2620,27734,2505
1600000US4830464,4830464,"Grand Prairie city, Texas",58703,2092,35298,2305,23405,2239
1600000US4832372,4832372,"Harlingen city, Texas",20831,1462,12213,1376,8618,1400
1600000US4835000,4835000,"Houston city, Texas",834204,9001,347479,8160,486725,10021
1600000US4837000,4837000,"Irving city, Texas",84734,2759,31102,1818,53632,2668
1600000US4839148,4839148,"Killeen city, Texas",48652,2048,22022,1440,26630,2158
1600000US4841464,4841464,"Laredo city, Texas",66985,1069,40670,1622,26315,1757
1600000US4841980,4841980,"League City city, Texas",32128,1859,21875,2127,10253,1797
1600000US4842508,4842508,"Lewisville city, Texas",39017,1563,16800,1546,22217,1916
1600000US4843888,4843888,"Longview city, Texas",31082,1502,17648,1536,13434,1493
1600000US4845000,4845000,"Lubbock city, Texas",94682,1981,48793,2447,45889,2675
1600000US4845384,4845384,"McAllen city, Texas",41458,1726,24016,2092,17442,1784
1600000US4845744,4845744,"McKinney city, Texas",53943,2114,35582,2413,18361,1947
1600000US4847892,4847892,"Mesquite city, Texas",47715,2313,26284,1963,21431,1707
1600000US4848072,4848072,"Midland city, Texas",43086,1561,27169,1909,15917,1844
1600000US4848768,4848768,"Mission city, Texas",22849,1642,16089,1888,6760,1364
1600000US4848804,4848804,"Missouri City city, Texas",23115,1880,18341,2101,4774,1336
1600000US4850820,4850820,"New Braunfels city, Texas",21463,1688,14605,1665,6858,1062
1600000US4852356,4852356,"North Richland Hills city, Texas",24849,1524,16205,1262,8644,1138
1600000US4853388,4853388,"Odessa city, Texas",40556,1922,23890,2091,16666,1932
1600000US4856000,4856000,"Pasadena city, Texas",49719,2011,26728,1878,22991,2145
1600000US4856348,4856348,"Pearland city, Texas",35128,1734,26996,1874,8132,1835
1600000US4857200,4857200,"Pharr city, Texas",20333,1418,13212,1545,7121,1435
1600000US4858016,4858016,"Plano city, Texas",104535,2898,65481,2326,39054,2427
1600000US4861796,4861796,"Richardson city, Texas",43569,2060,26054,2340,17515,1782
1600000US4863500,4863500,"Round Rock city, Texas",36034,1577,21580,1581,14454,1630
1600000US4864472,4864472,"San Angelo city, Texas",36051,1660,20566,1643,15485,2007
1600000US4865000,4865000,"San Antonio city, Texas",492940,4788,264388,5751,228552,5489
1600000US4870808,4870808,"Sugar Land city, Texas",28213,1927,24482,1896,3731,861
1600000US4872176,4872176,"Temple city, Texas",25732,1469,13092,1476,12640,1248
1600000US4872656,4872656,"The Woodlands CDP, Texas",38872,2644,27184,2210,11688,2157
1600000US4874144,4874144,"Tyler city, Texas",35901,1796,17921,1480,17980,1556
1600000US4875428,4875428,"Victoria city, Texas",24195,1230,13653,1052,10542,1252
1600000US4876000,4876000,"Waco city, Texas",46843,2003,20097,1879,26746,1881
1600000US4879000,4879000,"Wichita Falls city, Texas",34845,1958,20105,1628,14740,2107
1600000US4943660,4943660,"Layton city, Utah",22863,1237,16945,1204,5918,1044
1600000US4950150,4950150,"Millcreek CDP, Utah",26621,1967,15985,1558,10636,1464
1600000US4955980,4955980,"Ogden city, Utah",29689,1420,15870,1185,13819,1143
1600000US4957300,4957300,"Orem city, Utah",25216,1241,14284,1156,10932,1056
1600000US4962470,4962470,"Provo city, Utah",32916,1341,13543,1155,19373,1563
1600000US4965330,4965330,"St. George city, Utah",26640,1509,17047,1553,9593,1267
1600000US4967000,4967000,"Salt Lake City city, Utah",75923,2579,34691,2075,41232,2581
1600000US4967440,4967440,"Sandy city, Utah",27007,1242,20668,1231,6339,1106
1600000US4982950,4982950,"West Jordan city, Utah",32100,1686,24176,1794,7924,1597
1600000US4983470,4983470,"West Valley City city, Utah",35717,1911,25293,1837,10424,1414
1600000US5101000,5101000,"Alexandria city, Virginia",68796,1406,28587,1703,40209,1845
1600000US5103000,5103000,"Arlington CDP, Virginia",100732,1834,44566,2169,56166,2746
1600000US5114440,5114440,"Centreville CDP, Virginia",25676,1563,17673,1229,8003,1354
1600000US5116000,5116000,"Chesapeake city, Virginia",83904,1433,58818,2292,25086,2345
1600000US5121088,5121088,"Dale City CDP, Virginia",21194,1646,16102,1480,5092,1103
1600000US5135000,5135000,"Hampton city, Virginia",53420,1636,28187,1751,25233,1834
1600000US5147672,5147672,"Lynchburg city, Virginia",27870,1111,13990,966,13880,1421
1600000US5156000,5156000,"Newport News city, Virginia",68768,1569,33050,1624,35718,2203
1600000US5157000,5157000,"Norfolk city, Virginia",87760,1634,37359,1495,50401,1985
1600000US5164000,5164000,"Portsmouth city, Virginia",37123,1043,18430,1383,18693,1355
1600000US5167000,5167000,"Richmond city, Virginia",88421,1778,36430,1829,51991,2479
1600000US5168000,5168000,"Roanoke city, Virginia",42636,1451,21425,1637,21211,1907
1600000US5176432,5176432,"Suffolk city, Virginia",30689,1199,20801,1125,9888,1212
1600000US5182000,5182000,"Virginia Beach city, Virginia",167008,2587,106218,2649,60790,2901
1600000US5303180,5303180,"Auburn city, Washington",27524,1829,16186,1731,11338,1335
1600000US5305210,5305210,"Bellevue city, Washington",53945,2402,31276,2254,22669,1987
1600000US5305280,5305280,"Bellingham city, Washington",34963,1930,15428,1415,19535,1790
1600000US5322640,5322640,"Everett city, Washington",40895,1992,16796,1771,24099,1611
1600000US5323515,5323515,"Federal Way city, Washington",35121,1655,18811,1564,16310,1641
1600000US5335275,5335275,"Kennewick city, Washington",27028,1431,15983,1630,11045,1404
1600000US5335415,5335415,"Kent city, Washington",41586,2260,23845,2056,17741,1755
1600000US5335940,5335940,"Kirkland city, Washington",34240,1290,21324,1457,12916,1650
1600000US5343955,5343955,"Marysville city, Washington",24298,1375,16174,1533,8124,1222
1600000US5353545,5353545,"Pasco city, Washington",20549,956,13615,1236,6934,1222
1600000US5357745,5357745,"Renton city, Washington",36913,1845,18753,1663,18160,1780
1600000US5363000,5363000,"Seattle city, Washington",304564,4479,138638,3739,165926,4409
1600000US5367000,5367000,"Spokane city, Washington",85300,2097,46701,2266,38599,2163
1600000US5367167,5367167,"Spokane Valley city, Washington",36986,1538,22124,1546,14862,1733
1600000US5370000,5370000,"Tacoma city, Washington",78717,2620,38284,2330,40433,2636
1600000US5374060,5374060,"Vancouver city, Washington",67721,1880,32548,1866,35173,1973
1600000US5380010,5380010,"Yakima city, Washington",33212,1530,19344,1562,13868,1396
1600000US5502375,5502375,"Appleton city, Wisconsin",28648,1213,17703,1332,10945,1210
1600000US5522300,5522300,"Eau Claire city, Wisconsin",27180,1288,12832,930,14348,1226
1600000US5531000,5531000,"Green Bay city, Wisconsin",42292,1538,24169,1569,18123,1700
1600000US5539225,5539225,"Kenosha city, Wisconsin",36471,1510,21791,1421,14680,1363
1600000US5548000,5548000,"Madison city, Wisconsin",103771,2821,49958,1887,53813,2688
1600000US5553000,5553000,"Milwaukee city, Wisconsin",233161,3609,97841,3800,135320,4235
1600000US5560500,5560500,"Oshkosh city, Wisconsin",26698,1533,14092,1435,12606,1144
1600000US5566000,5566000,"Racine city, Wisconsin",29646,1497,15887,1433,13759,1405
1600000US5584250,5584250,"Waukesha city, Wisconsin",28137,1426,16317,1433,11820,1215
