GEO.id,GEO.id2,GEO.display-label,HD01_VD01,HD02_VD01,HD01_VD02,HD02_VD02,HD01_VD03,HD02_VD03
1600000US0107000,0107000,"Birmingham city, Alabama",89419,3385,45729,2591,43690,3039
1600000US0121184,0121184,"Dothan city, Alabama",24894,1080,16553,827,8341,775
1600000US0135896,0135896,"Hoover city, Alabama",30759,2270,20882,1264,9877,1900
1600000US0137000,0137000,"Huntsville city, Alabama",69278,2961,42269,2112,27009,2216
1600000US0150000,0150000,"Mobile city, Alabama",78703,2846,45513,2504,33190,2374
1600000US0151000,0151000,"Montgomery city, Alabama",78267,2912,49278,2303,28989,2621
1600000US0177256,0177256,"Tuscaloosa city, Alabama",30810,2165,14162,1257,16648,2019
1600000US0203000,0203000,"Anchorage municipality, Alaska",104675,1726,66107,2209,38568,2426
1600000US0404720,0404720,"Avondale city, Arizona",16549,1716,11159,1513,5390,1273
1600000US0412000,0412000,"Chandler city, Arizona",81763,3311,55579,2693,26184,2566
1600000US0427400,0427400,"Gilbert town, Arizona",52532,2893,40906,2546,11626,1879
1600000US0427820,0427820,"Glendale city, Arizona",76048,3925,48456,2734,27592,2886
1600000US0446000,0446000,"Mesa city, Arizona",172015,4566,115079,3987,56936,3616
1600000US0454050,0454050,"Peoria city, Arizona",55331,2601,43087,2502,12244,1821
1600000US0455000,0455000,"Phoenix city, Arizona",493898,7287,303014,5998,190884,6458
1600000US0465000,0465000,"Scottsdale city, Arizona",97975,4167,71455,3484,26520,3129
1600000US0471510,0471510,"Surprise city, Arizona",40614,2413,31662,2212,8952,1481
1600000US0473000,0473000,"Tempe city, Arizona",60147,3349,31766,2207,28381,2534
1600000US0477000,0477000,"Tucson city, Arizona",200658,4449,106342,3962,94316,4104
1600000US0485540,0485540,"Yuma city, Arizona",37403,2237,22235,2345,15168,1844
1600000US0523290,0523290,"Fayetteville city, Arkansas",28113,2118,12718,1392,15395,1605
1600000US0524550,0524550,"Fort Smith city, Arkansas",32114,1827,18468,1470,13646,1467
1600000US0541000,0541000,"Little Rock city, Arkansas",81976,3036,46875,2271,35101,3002
1600000US0566080,0566080,"Springdale city, Arkansas",22384,1600,11796,1436,10588,1705
1600000US0600562,0600562,"Alameda city, California",29050,1769,13979,1312,15071,1669
1600000US0600884,0600884,"Alhambra city, California",27824,1901,11760,1372,16064,1729
1600000US0602000,0602000,"Anaheim city, California",93021,3443,46517,2403,46504,2873
1600000US0602252,0602252,"Antioch city, California",32066,2278,20581,2095,11485,1987
1600000US0602364,0602364,"Apple Valley town, California",23024,1726,15018,1607,8006,1357
1600000US0602553,0602553,"Arden-Arcade CDP, California",38883,2425,19983,1527,18900,2084
1600000US0603526,0603526,"Bakersfield city, California",105658,3654,60475,2748,45183,3524
1600000US0603666,0603666,"Baldwin Park city, California",17304,1702,10172,1383,7132,1240
1600000US0604982,0604982,"Bellflower city, California",24824,1949,10012,1373,14812,1677
1600000US0606000,0606000,"Berkeley city, California",42577,2123,18514,1383,24063,2200
1600000US0608786,0608786,"Buena Park city, California",23976,1659,14411,1354,9565,1367
1600000US0608954,0608954,"Burbank city, California",42340,2486,19578,1819,22762,2214
1600000US0611194,0611194,"Carlsbad city, California",38643,2235,25611,2249,13032,1826
1600000US0611530,0611530,"Carson city, California",25130,2284,19622,1788,5508,1225
1600000US0613014,0613014,"Chico city, California",34397,1998,14307,1389,20090,1864
1600000US0613210,0613210,"Chino city, California",20451,1835,14816,1582,5635,1177
1600000US0613214,0613214,"Chino Hills city, California",22319,1622,17952,1501,4367,952
1600000US0613392,0613392,"Chula Vista city, California",69484,3243,43989,2752,25495,2323
1600000US0613588,0613588,"Citrus Heights city, California",33175,2187,18591,1613,14584,1592
1600000US0614218,0614218,"Clovis city, California",29527,1952,17939,1403,11588,1565
1600000US0615044,0615044,"Compton city, California",23658,1757,12552,1533,11106,1441
1600000US0616000,0616000,"Concord city, California",44400,2713,27808,2064,16592,1871
1600000US0616350,0616350,"Corona city, California",46935,2921,31579,2411,15356,1979
1600000US0616532,0616532,"Costa Mesa city, California",36983,2118,15614,1670,21369,1836
1600000US0617918,0617918,"Daly City city, California",28948,1799,16335,1391,12613,1631
1600000US0619766,0619766,"Downey city, California",32596,2398,17547,1890,15049,2077
1600000US0620802,0620802,"East Los Angeles CDP, California",28874,1834,10551,1316,18323,1728
1600000US0621712,0621712,"El Cajon city, California",33770,2487,14521,1378,19249,2050
1600000US0622020,0622020,"Elk Grove city, California",46406,2418,34395,2282,12011,1483
1600000US0622230,0622230,"El Monte city, California",27456,1830,10801,1371,16655,1723
1600000US0622804,0622804,"Escondido city, California",43857,2650,25149,1892,18708,2060
1600000US0623182,0623182,"Fairfield city, California",33571,2161,21460,1641,12111,1633
1600000US0624638,0624638,"Folsom city, California",25537,1516,17805,1296,7732,1314
1600000US0624680,0624680,"Fontana city, California",45210,2566,30528,2272,14682,1778
1600000US0626000,0626000,"Fremont city, California",63324,2692,41333,2303,21991,2082
1600000US0627000,0627000,"Fresno city, California",150610,3722,72062,3619,78548,3635
1600000US0628000,0628000,"Fullerton city, California",45370,2564,23789,1593,21581,2278
1600000US0629000,0629000,"Garden Grove city, California",50924,2517,29160,1972,21764,2205
1600000US0630000,0630000,"Glendale city, California",74095,3756,30405,2211,43690,2963
1600000US0632548,0632548,"Hawthorne city, California",28264,2047,7363,1247,20901,1867
1600000US0633000,0633000,"Hayward city, California",44404,2213,25335,1999,19069,1841
1600000US0633182,0633182,"Hemet city, California",29788,2453,18742,1695,11046,1744
1600000US0633434,0633434,"Hesperia city, California",26567,1910,18694,1718,7873,1552
1600000US0636000,0636000,"Huntington Beach city, California",74052,2918,45910,2159,28142,2540
1600000US0636448,0636448,"Indio city, California",21855,1776,14854,1454,7001,1254
1600000US0636546,0636546,"Inglewood city, California",38165,1874,13070,1313,25095,1853
1600000US0636770,0636770,"Irvine city, California",68987,2817,37600,1860,31387,2638
1600000US0639496,0639496,"Lake Forest city, California",23731,1453,17438,1275,6293,1189
1600000US0639892,0639892,"Lakewood city, California",27269,1564,20555,1480,6714,1470
1600000US0640130,0640130,"Lancaster city, California",45696,2545,28244,2329,17452,2144
1600000US0641992,0641992,"Livermore city, California",29208,2022,20682,1542,8526,1671
1600000US0643000,0643000,"Long Beach city, California",156730,4530,66013,2733,90717,4636
1600000US0644000,0644000,"Los Angeles city, California",1280535,12053,494850,8476,785685,12128
1600000US0644574,0644574,"Lynwood city, California",14447,1257,6936,1015,7511,1063
1600000US0645484,0645484,"Manteca city, California",19807,1843,12420,1429,7387,1384
1600000US0646898,0646898,"Merced city, California",24674,1725,9909,1372,14765,1804
1600000US0647766,0647766,"Milpitas city, California",18297,1551,12621,1183,5676,890
1600000US0648256,0648256,"Mission Viejo city, California",33551,1824,25990,1653,7561,1221
1600000US0648354,0648354,"Modesto city, California",65507,2629,38542,2207,26965,2339
1600000US0649270,0649270,"Moreno Valley city, California",50367,2641,32498,2132,17869,1991
1600000US0649670,0649670,"Mountain View city, California",31024,1699,12373,1095,18651,1960
1600000US0650076,0650076,"Murrieta city, California",29864,2355,22546,1854,7318,1515
1600000US0650258,0650258,"Napa city, California",27439,1539,16402,1449,11037,1533
1600000US0651182,0651182,"Newport Beach city, California",37943,2496,21330,2104,16613,2216
1600000US0652526,0652526,"Norwalk city, California",27242,1861,17162,1534,10080,1569
1600000US0653000,0653000,"Oakland city, California",143368,4433,60879,3315,82489,3743
1600000US0653322,0653322,"Oceanside city, California",57532,2682,33531,2148,24001,2397
1600000US0653896,0653896,"Ontario city, California",43496,2855,24346,2096,19150,2618
1600000US0653980,0653980,"Orange city, California",43161,2318,27519,1926,15642,1783
1600000US0654652,0654652,"Oxnard city, California",46440,2812,24947,1966,21493,2225
1600000US0655156,0655156,"Palmdale city, California",41054,2377,30257,2200,10797,1513
1600000US0656000,0656000,"Pasadena city, California",50625,2996,21669,1468,28956,2517
1600000US0657792,0657792,"Pleasanton city, California",24942,1532,17852,1457,7090,1086
1600000US0658072,0658072,"Pomona city, California",38439,2185,21261,1853,17178,1674
1600000US0659451,0659451,"Rancho Cucamonga city, California",52868,2888,34432,2554,18436,2103
1600000US0659920,0659920,"Redding city, California",37184,2143,21024,1805,16160,2044
1600000US0659962,0659962,"Redlands city, California",23744,1915,14079,1411,9665,1444
1600000US0660018,0660018,"Redondo Beach city, California",28131,1909,13665,1254,14466,1732
1600000US0660102,0660102,"Redwood City city, California",27826,1823,14797,1239,13029,1589
1600000US0660466,0660466,"Rialto city, California",25642,2203,14885,1816,10757,1675
1600000US0660620,0660620,"Richmond city, California",35594,2546,19094,1538,16500,2220
1600000US0662000,0662000,"Riverside city, California",90306,3555,48733,2942,41573,3156
1600000US0662938,0662938,"Roseville city, California",44952,2487,31059,2286,13893,1776
1600000US0664000,0664000,"Sacramento city, California",174586,4890,87463,3849,87123,3834
1600000US0664224,0664224,"Salinas city, California",40223,2157,18319,1659,21904,2172
1600000US0665000,0665000,"San Bernardino city, California",58604,2910,30977,2325,27627,2614
1600000US0665042,0665042,"San Buenaventura (Ventura) city, California",39942,2214,22211,1686,17731,2072
1600000US0666000,0666000,"San Diego city, California",467319,6965,232696,5171,234623,6909
1600000US0667000,0667000,"San Francisco city, California",323339,4231,127625,4686,195714,5676
1600000US0668000,0668000,"San Jose city, California",288561,5016,176337,4246,112224,5024
1600000US0668084,0668084,"San Leandro city, California",30876,1895,18544,1589,12332,1633
1600000US0668196,0668196,"San Marcos city, California",22436,1625,15052,1242,7384,1346
1600000US0668252,0668252,"San Mateo city, California",36784,1819,19368,1279,17416,1865
1600000US0669000,0669000,"Santa Ana city, California",73606,2945,35657,2255,37949,2864
1600000US0669070,0669070,"Santa Barbara city, California",34882,2017,13774,1403,21108,1947
1600000US0669084,0669084,"Santa Clara city, California",42278,2502,20776,1770,21502,2384
1600000US0669088,0669088,"Santa Clarita city, California",56046,2615,40128,2351,15918,2028
1600000US0669196,0669196,"Santa Maria city, California",24457,1840,12298,1554,12159,1595
1600000US0670000,0670000,"Santa Monica city, California",45919,2614,13382,1521,32537,2601
1600000US0670098,0670098,"Santa Rosa city, California",62627,2691,35462,2381,27165,2200
1600000US0672016,0672016,"Simi Valley city, California",40024,2052,30381,1832,9643,1513
1600000US0673080,0673080,"South Gate city, California",22464,1782,9522,1134,12942,1630
1600000US0675000,0675000,"Stockton city, California",86495,3310,44097,2662,42398,3011
1600000US0677000,0677000,"Sunnyvale city, California",52506,2487,27460,1800,25046,2186
1600000US0678120,0678120,"Temecula city, California",29599,2614,20607,1977,8992,1812
1600000US0678582,0678582,"Thousand Oaks city, California",42457,2330,31602,1914,10855,1404
1600000US0680000,0680000,"Torrance city, California",54652,2547,31529,2036,23123,2175
1600000US0680238,0680238,"Tracy city, California",22935,1864,15837,1746,7098,1363
1600000US0680812,0680812,"Turlock city, California",22995,1621,12337,1245,10658,1348
1600000US0680854,0680854,"Tustin city, California",27390,2050,13871,1304,13519,1715
1600000US0681204,0681204,"Union City city, California",17910,1354,13038,1495,4872,1073
1600000US0681344,0681344,"Upland city, California",24286,1736,14285,1373,10001,1492
1600000US0681554,0681554,"Vacaville city, California",29459,1848,18741,1576,10718,1679
1600000US0681666,0681666,"Vallejo city, California",39448,2368,22824,1762,16624,1860
1600000US0682590,0682590,"Victorville city, California",31887,2333,19180,1733,12707,1756
1600000US0682954,0682954,"Visalia city, California",39228,2263,24634,1931,14594,1989
1600000US0682996,0682996,"Vista city, California",28510,1889,15142,1422,13368,1826
1600000US0684200,0684200,"West Covina city, California",30737,2372,18988,1770,11749,1891
1600000US0684550,0684550,"Westminster city, California",25506,1830,14179,1164,11327,1639
1600000US0685292,0685292,"Whittier city, California",26861,2050,16148,1593,10713,1732
1600000US0686832,0686832,"Yorba Linda city, California",23174,1591,19756,1421,3418,950
1600000US0803455,0803455,"Arvada city, Colorado",42818,2002,32502,1551,10316,1443
1600000US0804000,0804000,"Aurora city, Colorado",118597,3398,77000,2723,41597,2801
1600000US0807850,0807850,"Boulder city, Colorado",39715,1823,19626,1267,20089,1793
1600000US0812815,0812815,"Centennial city, Colorado",37182,1580,32413,1597,4769,1069
1600000US0816000,0816000,"Colorado Springs city, Colorado",154534,3128,97163,3049,57371,2681
1600000US0820000,0820000,"Denver city, Colorado",248129,3995,136826,3772,111303,4166
1600000US0827425,0827425,"Fort Collins city, Colorado",57488,2448,32451,1899,25037,2362
1600000US0832155,0832155,"Greeley city, Colorado",32864,2166,18682,1419,14182,2165
1600000US0836410,0836410,"Highlands Ranch CDP, Colorado",33185,1785,27748,1731,5437,1168
1600000US0843000,0843000,"Lakewood city, Colorado",62515,2248,36038,1887,26477,2351
1600000US0845970,0845970,"Longmont city, Colorado",32952,1725,21335,1481,11617,1624
1600000US0846465,0846465,"Loveland city, Colorado",25720,1617,18668,1333,7052,1341
1600000US0862000,0862000,"Pueblo city, Colorado",42737,1939,26407,1753,16330,2053
1600000US0877290,0877290,"Thornton city, Colorado",37681,1976,27970,1732,9711,1589
1600000US0883835,0883835,"Westminster city, Colorado",40086,1616,27510,1448,12576,1628
1600000US0908000,0908000,"Bridgeport city, Connecticut",47906,3340,22325,2333,25581,2734
1600000US0918430,0918430,"Danbury city, Connecticut",29098,2093,18027,1613,11071,1863
1600000US0937000,0937000,"Hartford city, Connecticut",44560,2604,13238,1665,31322,2414
1600000US0950370,0950370,"New Britain city, Connecticut",26698,1931,11560,1546,15138,1593
1600000US0952000,0952000,"New Haven city, Connecticut",46013,2958,12599,1529,33414,2871
1600000US0955990,0955990,"Norwalk city, Connecticut",31003,1826,20822,1654,10181,1474
1600000US0973000,0973000,"Stamford city, Connecticut",46165,2736,26247,2026,19918,1982
1600000US0980000,0980000,"Waterbury city, Connecticut",43239,2513,22340,1907,20899,2194
1600000US1077580,1077580,"Wilmington city, Delaware",28543,1946,14662,1258,13881,1776
1600000US1150000,1150000,"Washington city, District of Columbia",249996,3353,108571,4051,141425,4835
1600000US1207300,1207300,"Boca Raton city, Florida",33192,1923,24536,1611,8656,1424
1600000US1207875,1207875,"Boynton Beach city, Florida",27055,2063,18082,1568,8973,1430
1600000US1208150,1208150,"Brandon CDP, Florida",36821,2461,23281,1933,13540,2016
1600000US1210275,1210275,"Cape Coral city, Florida",57933,3431,43916,2744,14017,2194
1600000US1212875,1212875,"Clearwater city, Florida",42366,2543,26797,1998,15569,2038
1600000US1214400,1214400,"Coral Springs city, Florida",41088,2426,29434,2016,11654,1664
1600000US1216475,1216475,"Davie town, Florida",36034,2529,27732,2130,8302,1606
1600000US1216725,1216725,"Deerfield Beach city, Florida",31247,2686,21585,2267,9662,1587
1600000US1217200,1217200,"Deltona city, Florida",32069,2542,27969,2696,4100,1215
1600000US1224000,1224000,"Fort Lauderdale city, Florida",71637,3717,42295,2828,29342,2768
1600000US1224125,1224125,"Fort Myers city, Florida",24116,2149,10009,1377,14107,1766
1600000US1225175,1225175,"Gainesville city, Florida",46694,2859,19427,1826,27267,2685
1600000US1230000,1230000,"Hialeah city, Florida",70394,3617,36660,2445,33734,3115
1600000US1232000,1232000,"Hollywood city, Florida",54617,3102,35884,2391,18733,2229
1600000US1235000,1235000,"Jacksonville city, Florida",318376,5235,204409,4616,113967,4084
1600000US1236100,1236100,"Kendall CDP, Florida",27575,2032,20832,1788,6743,1369
1600000US1238250,1238250,"Lakeland city, Florida",40528,2570,22859,1787,17669,2264
1600000US1239425,1239425,"Largo city, Florida",36419,2717,22343,2053,14076,1982
1600000US1239550,1239550,"Lauderhill city, Florida",24399,2354,15959,1702,8440,1428
1600000US1239925,1239925,"Lehigh Acres CDP, Florida",23034,1904,16719,1454,6315,1456
1600000US1243975,1243975,"Melbourne city, Florida",31835,1934,19867,1824,11968,1546
1600000US1245000,1245000,"Miami city, Florida",138786,5179,53275,3293,85511,4412
1600000US1245025,1245025,"Miami Beach city, Florida",41677,2465,18337,2003,23340,2266
1600000US1245060,1245060,"Miami Gardens city, Florida",31619,2064,23061,1913,8558,1402
1600000US1245975,1245975,"Miramar city, Florida",32793,2418,24695,2187,8098,1530
1600000US1253000,1253000,"Orlando city, Florida",92620,3687,39119,2930,53501,3220
1600000US1254000,1254000,"Palm Bay city, Florida",37114,1981,29026,1939,8088,1650
1600000US1254200,1254200,"Palm Coast city, Florida",28525,1823,21096,1886,7429,1776
1600000US1255775,1255775,"Pembroke Pines city, Florida",58451,3385,47159,3216,11292,1879
1600000US1257425,1257425,"Plantation city, Florida",31399,2104,23696,1912,7703,1493
1600000US1258050,1258050,"Pompano Beach city, Florida",42199,3129,26887,2298,15312,2119
1600000US1258715,1258715,"Port St. Lucie city, Florida",53063,2646,41530,2637,11533,1702
1600000US1263000,1263000,"St. Petersburg city, Florida",107799,4241,68103,3077,39696,3282
1600000US1268350,1268350,"Spring Hill CDP, Florida",37063,2141,29647,2037,7416,1572
1600000US1269700,1269700,"Sunrise city, Florida",34659,2522,25497,2309,9162,1668
1600000US1270600,1270600,"Tallahassee city, Florida",70712,2770,32937,2122,37775,2737
1600000US1271000,1271000,"Tampa city, Florida",135555,4299,75408,2820,60147,3674
1600000US1272145,1272145,"Town 'n' Country CDP, Florida",31427,2280,19680,1756,11747,1706
1600000US1276582,1276582,"Weston city, Florida",19923,1746,15376,1482,4547,1317
1600000US1276600,1276600,"West Palm Beach city, Florida",38847,2564,18492,1657,20355,2324
1600000US1301052,1301052,"Albany city, Georgia",28815,1816,13499,1387,15316,1824
1600000US1303440,1303440,"Athens-Clarke County unified government (balance), Georgia",40562,1905,18933,1452,21629,1974
1600000US1304000,1304000,"Atlanta city, Georgia",175210,5856,86414,4300,88796,4637
1600000US1304204,1304204,"Augusta-Richmond County consolidated government (balance), Georgia",73999,2460,44458,2287,29541,2354
1600000US1319000,1319000,"Columbus city, Georgia",72883,2693,42262,2353,30621,2473
1600000US1349000,1349000,"Macon city, Georgia",35498,2507,17833,1790,17665,2070
1600000US1349756,1349756,"Marietta city, Georgia",22270,1943,9724,1202,12546,1830
1600000US1367284,1367284,"Roswell city, Georgia",36578,2663,24858,1746,11720,2040
1600000US1368516,1368516,"Sandy Springs city, Georgia",39875,2818,22481,1808,17394,2059
1600000US1369000,1369000,"Savannah city, Georgia",51133,2673,25203,1998,25930,2614
1600000US1517000,1517000,"Honolulu CDP, Hawaii",143191,3569,72589,3081,70602,3283
1600000US1608830,1608830,"Boise City city, Idaho",85261,2955,52469,2530,32792,2782
1600000US1652120,1652120,"Meridian city, Idaho",23132,1810,18027,1494,5105,1341
1600000US1656260,1656260,"Nampa city, Idaho",27744,1863,19446,1628,8298,1500
1600000US1702154,1702154,"Arlington Heights village, Illinois",31171,1832,23894,1883,7277,1276
1600000US1703012,1703012,"Aurora city, Illinois",59785,2863,39994,2494,19791,2410
1600000US1706613,1706613,"Bloomington city, Illinois",29424,1491,19585,1286,9839,1088
1600000US1707133,1707133,"Bolingbrook village, Illinois",22204,1884,19155,1738,3049,933
1600000US1712385,1712385,"Champaign city, Illinois",31637,1918,14980,1044,16657,2004
1600000US1714000,1714000,"Chicago city, Illinois",1025027,10806,492157,9850,532870,8767
1600000US1714351,1714351,"Cicero town, Illinois",22052,1528,11598,1422,10454,1245
1600000US1718823,1718823,"Decatur city, Illinois",32115,1617,20714,1425,11401,1213
1600000US1723074,1723074,"Elgin city, Illinois",35236,1974,24388,1801,10848,1551
1600000US1724582,1724582,"Evanston city, Illinois",27593,1581,17767,1558,9826,1306
1600000US1738570,1738570,"Joliet city, Illinois",46340,2296,34218,2110,12122,1843
1600000US1751622,1751622,"Naperville city, Illinois",47821,1859,37453,1621,10368,1665
1600000US1757225,1757225,"Palatine village, Illinois",26119,1868,19861,1450,6258,1415
1600000US1759000,1759000,"Peoria city, Illinois",47063,1849,29308,1658,17755,1639
1600000US1765000,1765000,"Rockford city, Illinois",58493,2605,34856,2303,23637,2285
1600000US1768003,1768003,"Schaumburg village, Illinois",31499,2011,21913,1528,9586,1693
1600000US1770122,1770122,"Skokie village, Illinois",23445,1612,17210,1373,6235,1255
1600000US1772000,1772000,"Springfield city, Illinois",48536,1931,33263,2018,15273,1583
1600000US1779293,1779293,"Waukegan city, Illinois",28857,2094,17650,1736,11207,1549
1600000US1805860,1805860,"Bloomington city, Indiana",29830,1888,10474,1151,19356,1816
1600000US1810342,1810342,"Carmel city, Indiana",25276,1345,19939,1189,5337,1128
1600000US1822000,1822000,"Evansville city, Indiana",49782,2175,29028,1824,20754,2080
1600000US1823278,1823278,"Fishers town, Indiana",24804,1495,20211,1405,4593,1215
1600000US1825000,1825000,"Fort Wayne city, Indiana",102148,2930,67056,3063,35092,2638
1600000US1827000,1827000,"Gary city, Indiana",32120,2102,17795,1460,14325,1808
1600000US1831000,1831000,"Hammond city, Indiana",28104,1828,17887,1541,10217,1596
1600000US1836003,1836003,"Indianapolis city (balance), Indiana",324635,4586,195163,4665,129472,4691
1600000US1851876,1851876,"Muncie city, Indiana",25085,1715,14395,1463,10690,1394
1600000US1871000,1871000,"South Bend city, Indiana",39362,2105,24280,1433,15082,1846
1600000US1912000,1912000,"Cedar Rapids city, Iowa",52745,2005,36255,1977,16490,1610
1600000US1919000,1919000,"Davenport city, Iowa",40280,1854,24921,1642,15359,1413
1600000US1921000,1921000,"Des Moines city, Iowa",82925,2579,53929,2224,28996,1836
1600000US1938595,1938595,"Iowa City city, Iowa",24821,1639,12373,985,12448,1467
1600000US1973335,1973335,"Sioux City city, Iowa",31689,1317,20349,1684,11340,1544
1600000US1982425,1982425,"Waterloo city, Iowa",27981,1123,19196,1228,8785,1100
1600000US2036000,2036000,"Kansas City city, Kansas",54631,1647,33412,1892,21219,1878
1600000US2038900,2038900,"Lawrence city, Kansas",35060,1590,16159,1255,18901,1944
1600000US2052575,2052575,"Olathe city, Kansas",42093,1656,31515,1442,10578,1449
1600000US2053775,2053775,"Overland Park city, Kansas",70124,2271,46188,1571,23936,2234
1600000US2071000,2071000,"Topeka city, Kansas",56732,1858,33593,2166,23139,1901
1600000US2079000,2079000,"Wichita city, Kansas",151749,2766,93471,2707,58278,2915
1600000US2146027,2146027,"Lexington-Fayette urban county, Kentucky",123450,2589,73736,2825,49714,2708
1600000US2148006,2148006,"Louisville/Jefferson County metro government (balance), Kentucky",229862,4272,148716,3445,81146,4208
1600000US2205000,2205000,"Baton Rouge city, Louisiana",91734,3871,47256,2780,44478,3017
1600000US2239475,2239475,"Kenner city, Louisiana",22686,1818,14304,1375,8382,1341
1600000US2240735,2240735,"Lafayette city, Louisiana",47987,2146,26579,1826,21408,2132
1600000US2241155,2241155,"Lake Charles city, Louisiana",28470,1847,15513,1251,12957,1708
1600000US2250115,2250115,"Metairie CDP, Louisiana",56524,2466,36541,2058,19983,2024
1600000US2255000,2255000,"New Orleans city, Louisiana",87142,3198,45906,2315,41236,2430
1600000US2270000,2270000,"Shreveport city, Louisiana",77992,2789,42813,2501,35179,2420
1600000US2404000,2404000,"Baltimore city, Maryland",238454,4088,122463,4422,115991,4859
1600000US2419125,2419125,"Columbia CDP, Maryland",35647,1546,25274,1388,10373,1387
1600000US2426000,2426000,"Ellicott City CDP, Maryland",23356,1293,16841,990,6515,1032
1600000US2472450,2472450,"Silver Spring CDP, Maryland",27928,1961,13698,1394,14230,1715
1600000US2507000,2507000,"Boston city, Massachusetts",232969,5422,85849,4282,147120,5409
1600000US2509000,2509000,"Brockton city, Massachusetts",32723,2349,18827,1909,13896,1547
1600000US2509210,2509210,"Brookline CDP, Massachusetts",26985,1763,13407,1263,13578,1586
1600000US2511000,2511000,"Cambridge city, Massachusetts",41800,1890,15953,1458,25847,1893
1600000US2523000,2523000,"Fall River city, Massachusetts",37024,2293,13859,1489,23165,2276
1600000US2524960,2524960,"Framingham CDP, Massachusetts",26265,1914,15787,1334,10478,1515
1600000US2534550,2534550,"Lawrence city, Massachusetts",25188,1743,9128,1139,16060,1800
1600000US2537000,2537000,"Lowell city, Massachusetts",35246,1952,18269,1550,16977,1814
1600000US2537490,2537490,"Lynn city, Massachusetts",33098,2130,15591,1651,17507,1869
1600000US2545000,2545000,"New Bedford city, Massachusetts",36421,2506,15627,1347,20794,2059
1600000US2545560,2545560,"Newton city, Massachusetts",32586,1592,22488,1331,10098,1474
1600000US2555745,2555745,"Quincy city, Massachusetts",40525,2288,20175,2093,20350,1835
1600000US2562535,2562535,"Somerville city, Massachusetts",31070,2247,10607,1273,20463,2219
1600000US2567000,2567000,"Springfield city, Massachusetts",54687,2781,29329,2174,25358,2117
1600000US2582000,2582000,"Worcester city, Massachusetts",65329,2846,29486,1876,35843,3075
1600000US2603000,2603000,"Ann Arbor city, Michigan",45617,2728,20737,1351,24880,2258
1600000US2613110,2613110,"Canton CDP, Michigan",32986,1828,26254,1647,6732,1297
1600000US2616510,2616510,"Clinton CDP, Michigan",41314,1887,28844,1445,12470,1634
1600000US2621000,2621000,"Dearborn city, Michigan",35166,1913,25423,1628,9743,1754
1600000US2622000,2622000,"Detroit city, Michigan",263630,5644,140523,4804,123107,4290
1600000US2627440,2627440,"Farmington Hills city, Michigan",32769,1973,21729,1592,11040,1540
1600000US2629000,2629000,"Flint city, Michigan",41884,1857,21936,1804,19948,1796
1600000US2634000,2634000,"Grand Rapids city, Michigan",71616,2939,42360,2235,29256,2307
1600000US2642160,2642160,"Kalamazoo city, Michigan",27664,1741,13320,1233,14344,1610
1600000US2646000,2646000,"Lansing city, Michigan",44809,2295,27534,1811,17275,1845
1600000US2649000,2649000,"Livonia city, Michigan",36266,1641,32061,1482,4205,866
1600000US2665440,2665440,"Pontiac city, Michigan",22236,1693,11372,1307,10864,1529
1600000US2669035,2669035,"Rochester Hills city, Michigan",27350,1388,20911,1342,6439,1103
1600000US2672818,2672818,"Shelby CDP, Michigan",26224,1440,20818,1302,5406,1017
1600000US2674900,2674900,"Southfield city, Michigan",29971,2165,16145,1473,13826,1873
1600000US2676460,2676460,"Sterling Heights city, Michigan",47679,1595,37291,1705,10388,1265
1600000US2680700,2680700,"Troy city, Michigan",31149,1488,23801,1206,7348,1095
1600000US2684000,2684000,"Warren city, Michigan",53357,1821,40371,1621,12986,1629
1600000US2684220,2684220,"Waterford CDP, Michigan",29316,1501,22183,1262,7133,1167
1600000US2685510,2685510,"West Bloomfield Township CDP, Michigan",23814,1369,20400,1284,3414,854
1600000US2686000,2686000,"Westland city, Michigan",34492,2236,23349,1655,11143,1524
1600000US2688940,2688940,"Wyoming city, Michigan",26304,1775,18580,1528,7724,1629
1600000US2706616,2706616,"Bloomington city, Minnesota",36409,1867,25741,1655,10668,1423
1600000US2707966,2707966,"Brooklyn Park city, Minnesota",25876,1742,20456,1626,5420,1088
1600000US2717000,2717000,"Duluth city, Minnesota",36420,1909,21339,1351,15081,1870
1600000US2743000,2743000,"Minneapolis city, Minnesota",160600,3784,84689,3233,75911,4127
1600000US2751730,2751730,"Plymouth city, Minnesota",28590,1455,22141,1270,6449,1058
1600000US2754880,2754880,"Rochester city, Minnesota",40718,1482,29438,1438,11280,1256
1600000US2756896,2756896,"St. Cloud city, Minnesota",24993,1435,14555,1220,10438,1396
1600000US2758000,2758000,"St. Paul city, Minnesota",109044,2739,62336,2482,46708,3003
1600000US2829700,2829700,"Gulfport city, Mississippi",26246,2261,14935,1881,11311,1847
1600000US2836000,2836000,"Jackson city, Mississippi",64405,2701,34044,2216,30361,2453
1600000US2915670,2915670,"Columbia city, Missouri",40233,2016,18195,1530,22038,2019
1600000US2935000,2935000,"Independence city, Missouri",46966,1926,30597,1854,16369,1833
1600000US2938000,2938000,"Kansas City city, Missouri",185761,4494,111519,4017,74242,3818
1600000US2941348,2941348,"Lee's Summit city, Missouri",36051,1996,27081,1517,8970,1670
1600000US2954074,2954074,"O'Fallon city, Missouri",25130,1704,22716,1619,2414,701
1600000US2964550,2964550,"St. Joseph city, Missouri",28009,1934,17607,1755,10402,1402
1600000US2965000,2965000,"St. Louis city, Missouri",142299,3024,72813,2954,69486,3882
1600000US2970000,2970000,"Springfield city, Missouri",69078,2130,34516,1849,34562,2235
1600000US3006550,3006550,"Billings city, Montana",41079,1468,26371,1332,14708,1356
1600000US3050200,3050200,"Missoula city, Montana",27646,1287,14440,1480,13206,1418
1600000US3128000,3128000,"Lincoln city, Nebraska",98231,2728,61079,2249,37152,2602
1600000US3137000,3137000,"Omaha city, Nebraska",158685,2924,95667,2806,63018,2711
1600000US3223770,3223770,"Enterprise CDP, Nevada",33214,2629,20523,2489,12691,1898
1600000US3231900,3231900,"Henderson city, Nevada",96195,3555,63246,2969,32949,3030
1600000US3240000,3240000,"Las Vegas city, Nevada",210008,5275,119040,4035,90968,4091
1600000US3251800,3251800,"North Las Vegas city, Nevada",66771,3357,44574,2610,22197,2654
1600000US3254600,3254600,"Paradise CDP, Nevada",81248,3138,36866,2331,44382,3014
1600000US3260600,3260600,"Reno city, Nevada",86759,2724,41452,2479,45307,3184
1600000US3268400,3268400,"Sparks city, Nevada",30609,1952,19429,1557,11180,1803
1600000US3268585,3268585,"Spring Valley CDP, Nevada",65795,3087,35847,2398,29948,2686
1600000US3271400,3271400,"Sunrise Manor CDP, Nevada",62515,3441,35785,2602,26730,2405
1600000US3345140,3345140,"Manchester city, New Hampshire",43461,2147,21260,1755,22201,1838
1600000US3350260,3350260,"Nashua city, New Hampshire",34349,1960,20395,1545,13954,1834
1600000US3410000,3410000,"Camden city, New Jersey",22711,1631,9066,1229,13645,1542
1600000US3413690,3413690,"Clifton city, New Jersey",28102,2068,17165,1775,10937,1555
1600000US3419390,3419390,"East Orange city, New Jersey",25219,2030,5907,1001,19312,1907
1600000US3420260,3420260,"Edison CDP, New Jersey",35350,1761,22375,1524,12975,1674
1600000US3421000,3421000,"Elizabeth city, New Jersey",39399,2168,11448,1447,27951,1891
1600000US3436000,3436000,"Jersey City city, New Jersey",90546,3329,30347,2255,60199,2874
1600000US3451000,3451000,"Newark city, New Jersey",92048,3016,22867,2208,69181,2808
1600000US3456550,3456550,"Passaic city, New Jersey",17917,1792,4900,982,13017,1678
1600000US3457000,3457000,"Paterson city, New Jersey",42539,2169,14913,1893,27626,2041
1600000US3473110,3473110,"Toms River CDP, New Jersey",34734,1600,29411,1583,5323,1056
1600000US3474000,3474000,"Trenton city, New Jersey",27371,1767,11038,1351,16333,1899
1600000US3474630,3474630,"Union City city, New Jersey",23158,1698,5035,962,18123,1844
1600000US3502000,3502000,"Albuquerque city, New Mexico",212579,4080,130974,3888,81605,3840
1600000US3539380,3539380,"Las Cruces city, New Mexico",36679,1977,21103,1642,15576,1948
1600000US3563460,3563460,"Rio Rancho city, New Mexico",30360,1385,24060,1610,6300,1320
1600000US3570500,3570500,"Santa Fe city, New Mexico",28217,1538,16681,1508,11536,1448
1600000US3601000,3601000,"Albany city, New York",37394,2013,16300,1573,21094,1967
1600000US3611000,3611000,"Buffalo city, New York",115386,3245,46837,2381,68549,3881
1600000US3615000,3615000,"Cheektowaga CDP, New York",34623,1720,23679,1389,10944,1673
1600000US3649121,3649121,"Mount Vernon city, New York",23739,1759,9813,1310,13926,1586
1600000US3650617,3650617,"New Rochelle city, New York",26002,1894,12055,1139,13947,1543
1600000US3651000,3651000,"New York city, New York",3055275,14420,1031691,13955,2023584,18590
1600000US3663000,3663000,"Rochester city, New York",77145,3485,33626,2091,43519,3297
1600000US3673000,3673000,"Syracuse city, New York",55971,2204,22558,1615,33413,2384
1600000US3684000,3684000,"Yonkers city, New York",73008,3297,34079,1986,38929,3058
1600000US3702140,3702140,"Asheville city, North Carolina",35059,1954,17690,1355,17369,1785
1600000US3710740,3710740,"Cary town, North Carolina",44072,2113,33744,1482,10328,1728
1600000US3712000,3712000,"Charlotte city, North Carolina",286163,4860,169750,4700,116413,5114
1600000US3714100,3714100,"Concord city, North Carolina",26542,1689,16952,1664,9590,1278
1600000US3719000,3719000,"Durham city, North Carolina",88558,4008,44758,2205,43800,4206
1600000US3722920,3722920,"Fayetteville city, North Carolina",74052,3197,42405,2942,31647,3098
1600000US3725580,3725580,"Gastonia city, North Carolina",25791,1994,15414,1513,10377,1537
1600000US3728000,3728000,"Greensboro city, North Carolina",98142,3366,54860,2729,43282,2576
1600000US3728080,3728080,"Greenville city, North Carolina",31927,1879,12062,1482,19865,1896
1600000US3731400,3731400,"High Point city, North Carolina",38378,2312,23614,1840,14764,2123
1600000US3734200,3734200,"Jacksonville city, North Carolina",18751,2317,7553,1141,11198,1978
1600000US3755000,3755000,"Raleigh city, North Carolina",144709,4107,77775,3108,66934,3412
1600000US3774440,3774440,"Wilmington city, North Carolina",45215,3038,23886,1795,21329,2465
1600000US3775000,3775000,"Winston-Salem city, North Carolina",86634,2775,50502,2355,36132,2387
1600000US3825700,3825700,"Fargo city, North Dakota",44948,1982,20275,1417,24673,2194
1600000US3901000,3901000,"Akron city, Ohio",83352,3431,46848,2602,36504,2591
1600000US3912000,3912000,"Canton city, Ohio",28706,2019,14943,1490,13763,1731
1600000US3915000,3915000,"Cincinnati city, Ohio",126103,4119,53960,3004,72143,3950
1600000US3916000,3916000,"Cleveland city, Ohio",168628,4006,77915,3330,90713,4069
1600000US3918000,3918000,"Columbus city, Ohio",309255,5060,154745,4576,154510,4886
1600000US3921000,3921000,"Dayton city, Ohio",59495,2959,30349,2114,29146,2710
1600000US3944856,3944856,"Lorain city, Ohio",25444,1657,15622,1445,9822,1206
1600000US3961000,3961000,"Parma city, Ohio",33347,1425,25637,1214,7710,1284
1600000US3977000,3977000,"Toledo city, Ohio",118986,2898,69895,2591,49091,2535
1600000US3988000,3988000,"Youngstown city, Ohio",29236,1671,17555,1466,11681,1445
1600000US4009050,4009050,"Broken Arrow city, Oklahoma",35696,1991,29588,2024,6108,1071
1600000US4023200,4023200,"Edmond city, Oklahoma",31201,2053,21540,1512,9661,1605
1600000US4041850,4041850,"Lawton city, Oklahoma",32330,1844,17427,1446,14903,1900
1600000US4052500,4052500,"Norman city, Oklahoma",40145,2340,22664,1590,17481,1827
1600000US4055000,4055000,"Oklahoma City city, Oklahoma",223234,4549,138155,3928,85079,4298
1600000US4075000,4075000,"Tulsa city, Oklahoma",165974,3355,89826,3136,76148,3451
1600000US4105350,4105350,"Beaverton city, Oregon",35769,1825,17603,1461,18166,1785
1600000US4105800,4105800,"Bend city, Oregon",31443,1884,18711,1739,12732,1633
1600000US4123850,4123850,"Eugene city, Oregon",64257,2384,32862,1636,31395,2242
1600000US4131250,4131250,"Gresham city, Oregon",37786,2211,23083,1557,14703,1967
1600000US4134100,4134100,"Hillsboro city, Oregon",32622,2122,20036,1610,12586,1763
1600000US4147000,4147000,"Medford city, Oregon",30621,1760,16187,1421,14434,1698
1600000US4159000,4159000,"Portland city, Oregon",237202,4045,139177,4266,98025,3887
1600000US4164900,4164900,"Salem city, Oregon",54558,2147,31614,1965,22944,2236
1600000US4202000,4202000,"Allentown city, Pennsylvania",41038,2041,21780,1781,19258,1584
1600000US4206088,4206088,"Bethlehem city, Pennsylvania",28341,1779,16555,1377,11786,1251
1600000US4224000,4224000,"Erie city, Pennsylvania",37547,1981,21595,1567,15952,1844
1600000US4260000,4260000,"Philadelphia city, Pennsylvania",578263,6909,325179,8123,253084,7064
1600000US4261000,4261000,"Pittsburgh city, Pennsylvania",129994,3569,67830,2673,62164,3536
1600000US4263624,4263624,"Reading city, Pennsylvania",28261,1570,12234,1430,16027,1562
1600000US4269000,4269000,"Scranton city, Pennsylvania",30286,1675,15217,1254,15069,1555
1600000US4419180,4419180,"Cranston city, Rhode Island",30140,1923,19729,1780,10411,1705
1600000US4454640,4454640,"Pawtucket city, Rhode Island",27173,1971,13479,1306,13694,1718
1600000US4459000,4459000,"Providence city, Rhode Island",59166,2786,22534,2162,36632,2574
1600000US4474300,4474300,"Warwick city, Rhode Island",34559,1493,26109,1550,8450,1360
1600000US4513330,4513330,"Charleston city, South Carolina",48722,2710,27196,2115,21526,2236
1600000US4516000,4516000,"Columbia city, South Carolina",42449,2205,21087,1411,21362,1788
1600000US4548535,4548535,"Mount Pleasant town, South Carolina",26189,1861,20837,1762,5352,1247
1600000US4550875,4550875,"North Charleston city, South Carolina",32567,2077,16624,1256,15943,1788
1600000US4561405,4561405,"Rock Hill city, South Carolina",24034,1891,13607,1337,10427,1756
1600000US4652980,4652980,"Rapid City city, South Dakota",25604,1436,14434,1195,11170,1283
1600000US4659020,4659020,"Sioux Falls city, South Dakota",60819,1436,38319,1894,22500,1758
1600000US4714000,4714000,"Chattanooga city, Tennessee",68055,2790,38391,2405,29664,2077
1600000US4715160,4715160,"Clarksville city, Tennessee",46655,1730,28939,1909,17716,2116
1600000US4740000,4740000,"Knoxville city, Tennessee",83412,2488,41627,2209,41785,2287
1600000US4748000,4748000,"Memphis city, Tennessee",244929,4698,135138,3834,109791,4062
1600000US4751560,4751560,"Murfreesboro city, Tennessee",39501,2379,21282,1641,18219,2190
1600000US4752006,4752006,"Nashville-Davidson metropolitan government (balance), Tennessee",247051,4069,150985,3536,96066,4196
1600000US4801000,4801000,"Abilene city, Texas",43708,1642,26276,1883,17432,2095
1600000US4801924,4801924,"Allen city, Texas",26242,1964,21012,1526,5230,1304
1600000US4803000,4803000,"Amarillo city, Texas",69328,2349,41950,2285,27378,2307
1600000US4804000,4804000,"Arlington city, Texas",126770,3951,75011,2929,51759,3409
1600000US4805000,4805000,"Austin city, Texas",314344,5635,149392,5038,164952,5185
1600000US4806128,4806128,"Baytown city, Texas",26761,2221,16803,1734,9958,1631
1600000US4807000,4807000,"Beaumont city, Texas",44389,4243,26210,1786,18179,3722
1600000US4810768,4810768,"Brownsville city, Texas",51521,2679,31733,2118,19788,2279
1600000US4810912,4810912,"Bryan city, Texas",26560,1913,12520,1364,14040,1783
1600000US4813024,4813024,"Carrollton city, Texas",41904,2535,28587,1952,13317,1991
1600000US4815976,4815976,"College Station city, Texas",27855,1973,9865,1097,17990,1924
1600000US4817000,4817000,"Corpus Christi city, Texas",104596,2812,63207,2671,41389,2961
1600000US4819000,4819000,"Dallas city, Texas",453692,7265,209745,5024,243947,6145
1600000US4819972,4819972,"Denton city, Texas",36711,2594,17340,1608,19371,1989
1600000US4822660,4822660,"Edinburg city, Texas",23189,2098,12348,1485,10841,1739
1600000US4824000,4824000,"El Paso city, Texas",200610,3052,126838,3595,73772,3707
1600000US4826232,4826232,"Flower Mound town, Texas",18584,1405,17189,1371,1395,545
1600000US4827000,4827000,"Fort Worth city, Texas",237796,4500,141051,4164,96745,4118
1600000US4827684,4827684,"Frisco city, Texas",34743,2080,27380,1726,7363,1246
1600000US4829000,4829000,"Garland city, Texas",74240,3701,49100,3179,25140,2623
1600000US4830464,4830464,"Grand Prairie city, Texas",58366,3036,35637,2634,22729,2121
1600000US4835000,4835000,"Houston city, Texas",756224,8755,353126,6822,403098,8240
1600000US4837000,4837000,"Irving city, Texas",78107,3027,33119,2038,44988,2783
1600000US4839148,4839148,"Killeen city, Texas",38506,2772,20770,2089,17736,2083
1600000US4841464,4841464,"Laredo city, Texas",60610,1580,38546,1952,22064,1848
1600000US4841980,4841980,"League City city, Texas",28605,2136,22700,1741,5905,1282
1600000US4842508,4842508,"Lewisville city, Texas",31673,2253,15035,1234,16638,1960
1600000US4843888,4843888,"Longview city, Texas",30004,1570,16147,1485,13857,1806
1600000US4845000,4845000,"Lubbock city, Texas",87721,2540,52764,2203,34957,2696
1600000US4845384,4845384,"McAllen city, Texas",41412,2607,24660,1954,16752,2182
1600000US4845744,4845744,"McKinney city, Texas",40564,2347,30081,1870,10483,1687
1600000US4847892,4847892,"Mesquite city, Texas",48553,3191,32133,2538,16420,2166
1600000US4848072,4848072,"Midland city, Texas",39526,1292,26841,1492,12685,1415
1600000US4848768,4848768,"Mission city, Texas",21210,1797,15739,1701,5471,1353
1600000US4848804,4848804,"Missouri City city, Texas",20306,1656,17960,1486,2346,1017
1600000US4852356,4852356,"North Richland Hills city, Texas",23249,1854,15991,1323,7258,1462
1600000US4853388,4853388,"Odessa city, Texas",36103,1883,22812,1960,13291,1700
1600000US4856000,4856000,"Pasadena city, Texas",53341,3028,30571,2222,22770,2461
1600000US4856348,4856348,"Pearland city, Texas",28525,1660,23423,1698,5102,1141
1600000US4857200,4857200,"Pharr city, Texas",19364,2244,11919,1558,7445,1707
1600000US4858016,4858016,"Plano city, Texas",95204,3261,62742,2874,32462,2577
1600000US4861796,4861796,"Richardson city, Texas",37310,2077,23647,1372,13663,1689
1600000US4863500,4863500,"Round Rock city, Texas",28363,2017,17431,1659,10932,1744
1600000US4864472,4864472,"San Angelo city, Texas",34345,2076,20572,1750,13773,1832
1600000US4865000,4865000,"San Antonio city, Texas",447106,5985,267057,5247,180049,6610
1600000US4870808,4870808,"Sugar Land city, Texas",20141,1755,16393,1485,3748,1017
1600000US4874144,4874144,"Tyler city, Texas",31993,1922,18304,1655,13689,1630
1600000US4876000,4876000,"Waco city, Texas",44909,1884,19269,1639,25640,1951
1600000US4879000,4879000,"Wichita Falls city, Texas",39216,2295,24266,1874,14950,1754
1600000US4943660,4943660,"Layton city, Utah",21536,1256,16016,1191,5520,1049
1600000US4955980,4955980,"Ogden city, Utah",30961,1590,17913,1481,13048,1542
1600000US4957300,4957300,"Orem city, Utah",27124,1417,16778,1434,10346,1528
1600000US4962470,4962470,"Provo city, Utah",30561,1768,15288,1253,15273,1402
1600000US4965330,4965330,"St. George city, Utah",26458,1778,17058,1263,9400,1387
1600000US4967000,4967000,"Salt Lake City city, Utah",72079,2745,35685,2325,36394,2721
1600000US4967440,4967440,"Sandy city, Utah",28207,1687,23065,1547,5142,1143
1600000US4982950,4982950,"West Jordan city, Utah",31398,2053,24052,1655,7346,1743
1600000US4983470,4983470,"West Valley City city, Utah",36620,2132,26423,2071,10197,1469
1600000US5101000,5101000,"Alexandria city, Virginia",61689,2102,30498,2033,31191,1830
1600000US5103000,5103000,"Arlington CDP, Virginia",92352,2847,48327,2426,44025,2843
1600000US5116000,5116000,"Chesapeake city, Virginia",79876,1152,56995,1973,22881,2078
1600000US5135000,5135000,"Hampton city, Virginia",54495,1330,30992,1671,23503,1933
1600000US5147672,5147672,"Lynchburg city, Virginia",27534,1620,15999,1532,11535,1436
1600000US5156000,5156000,"Newport News city, Virginia",71717,1943,37245,1841,34472,2379
1600000US5157000,5157000,"Norfolk city, Virginia",84860,4466,39923,2412,44937,3799
1600000US5164000,5164000,"Portsmouth city, Virginia",37492,1602,23534,1418,13958,1722
1600000US5167000,5167000,"Richmond city, Virginia",79967,3609,40125,2446,39842,3233
1600000US5168000,5168000,"Roanoke city, Virginia",42633,1253,25493,1775,17140,1838
1600000US5176432,5176432,"Suffolk city, Virginia",30667,940,22889,1391,7778,1276
1600000US5182000,5182000,"Virginia Beach city, Virginia",162366,3507,107011,2911,55355,3353
1600000US5305210,5305210,"Bellevue city, Washington",48764,2026,29345,1784,19419,2030
1600000US5305280,5305280,"Bellingham city, Washington",31658,1987,14530,1375,17128,1936
1600000US5322640,5322640,"Everett city, Washington",41767,2439,19473,1564,22294,2141
1600000US5323515,5323515,"Federal Way city, Washington",34329,2315,21918,1767,12411,1647
1600000US5335415,5335415,"Kent city, Washington",34183,2359,17261,1459,16922,2186
1600000US5363000,5363000,"Seattle city, Washington",272508,5410,141766,4465,130742,4178
1600000US5367000,5367000,"Spokane city, Washington",87377,3084,48492,2405,38885,2916
1600000US5367167,5367167,"Spokane Valley city, Washington",35454,1707,22974,1532,12480,1668
1600000US5370000,5370000,"Tacoma city, Washington",78623,3032,42453,2241,36170,2765
1600000US5374060,5374060,"Vancouver city, Washington",65225,2651,33562,2179,31663,2386
1600000US5380010,5380010,"Yakima city, Washington",31356,1963,16849,1966,14507,1804
1600000US5502375,5502375,"Appleton city, Wisconsin",27438,1353,19260,1156,8178,1268
1600000US5522300,5522300,"Eau Claire city, Wisconsin",25597,1294,15004,1204,10593,1336
1600000US5531000,5531000,"Green Bay city, Wisconsin",41535,2036,25584,1750,15951,1804
1600000US5539225,5539225,"Kenosha city, Wisconsin",35772,1557,21913,1553,13859,1688
1600000US5548000,5548000,"Madison city, Wisconsin",95296,2920,50222,2124,45074,2690
1600000US5553000,5553000,"Milwaukee city, Wisconsin",221194,3771,105918,3227,115276,3892
1600000US5566000,5566000,"Racine city, Wisconsin",28886,1776,17778,1433,11108,1496
1600000US5584250,5584250,"Waukesha city, Wisconsin",27232,1764,16851,1162,10381,1468
