GEO.id,GEO.id2,GEO.display-label,HD01_VD01,HD02_VD01,HD01_VD02,HD02_VD02,HD01_VD03,HD02_VD03
1600000US0107000,0107000,"Birmingham city, Alabama",88481,3290,47479,2772,41002,3060
1600000US0121184,0121184,"Dothan city, Alabama",24284,1032,15562,801,8722,781
1600000US0135896,0135896,"Hoover city, Alabama",29878,1901,20946,1469,8932,1719
1600000US0137000,0137000,"Huntsville city, Alabama",68403,2371,41949,2138,26454,2170
1600000US0150000,0150000,"Mobile city, Alabama",73787,2335,43594,2150,30193,1927
1600000US0151000,0151000,"Montgomery city, Alabama",80391,2037,49790,2551,30601,2247
1600000US0177256,0177256,"Tuscaloosa city, Alabama",32847,1607,15593,1549,17254,1881
1600000US0203000,0203000,"Anchorage municipality, Alaska",102942,1646,62358,2291,40584,2488
1600000US0404720,0404720,"Avondale city, Arizona",19367,1542,13314,1330,6053,1352
1600000US0412000,0412000,"Chandler city, Arizona",81033,3103,56985,2815,24048,2852
1600000US0427400,0427400,"Gilbert town, Arizona",61743,2610,48932,2518,12811,1695
1600000US0427820,0427820,"Glendale city, Arizona",78091,3625,49275,2424,28816,3075
1600000US0446000,0446000,"Mesa city, Arizona",170598,4665,111951,3854,58647,3445
1600000US0454050,0454050,"Peoria city, Arizona",52982,2535,42195,2290,10787,1889
1600000US0455000,0455000,"Phoenix city, Arizona",493292,6784,304886,6791,188406,6529
1600000US0465000,0465000,"Scottsdale city, Arizona",95966,3901,69386,3097,26580,2681
1600000US0471510,0471510,"Surprise city, Arizona",37863,2236,31932,2194,5931,1306
1600000US0473000,0473000,"Tempe city, Arizona",59542,2766,28115,2040,31427,2797
1600000US0477000,0477000,"Tucson city, Arizona",207328,4787,108832,3596,98496,4399
1600000US0485540,0485540,"Yuma city, Arizona",37738,2425,22222,1848,15516,2014
1600000US0523290,0523290,"Fayetteville city, Arkansas",29469,1758,11951,1305,17518,1837
1600000US0524550,0524550,"Fort Smith city, Arkansas",32544,1450,16795,1642,15749,1551
1600000US0541000,0541000,"Little Rock city, Arkansas",78112,2398,47257,2332,30855,2325
1600000US0566080,0566080,"Springdale city, Arkansas",22766,1761,14878,1713,7888,1320
1600000US0600562,0600562,"Alameda city, California",29091,1741,14763,1347,14328,1698
1600000US0600884,0600884,"Alhambra city, California",29715,1944,12500,1381,17215,1702
1600000US0602000,0602000,"Anaheim city, California",99382,3737,50096,2541,49286,3594
1600000US0602252,0602252,"Antioch city, California",32067,2236,24026,1938,8041,1552
1600000US0602364,0602364,"Apple Valley town, California",23784,1862,15992,1533,7792,1485
1600000US0602553,0602553,"Arden-Arcade CDP, California",40749,1998,20167,1590,20582,1641
1600000US0603526,0603526,"Bakersfield city, California",102185,3102,60980,2922,41205,3105
1600000US0603666,0603666,"Baldwin Park city, California",16631,1363,11021,1405,5610,1080
1600000US0604982,0604982,"Bellflower city, California",23502,1885,10563,1498,12939,1594
1600000US0606000,0606000,"Berkeley city, California",41224,2186,19715,1454,21509,2029
1600000US0608786,0608786,"Buena Park city, California",23710,1626,14180,1421,9530,1307
1600000US0608954,0608954,"Burbank city, California",40474,2431,17834,1696,22640,2289
1600000US0611194,0611194,"Carlsbad city, California",39101,2416,26185,1961,12916,1880
1600000US0611530,0611530,"Carson city, California",26413,1954,19864,1899,6549,1351
1600000US0613014,0613014,"Chico city, California",32846,1933,14416,1544,18430,1780
1600000US0613210,0613210,"Chino city, California",20534,1857,14144,1574,6390,1285
1600000US0613214,0613214,"Chino Hills city, California",23957,1921,19401,1691,4556,1361
1600000US0613392,0613392,"Chula Vista city, California",72294,3083,42177,2722,30117,2766
1600000US0613588,0613588,"Citrus Heights city, California",35199,2474,21496,1903,13703,1880
1600000US0614218,0614218,"Clovis city, California",32085,2017,19568,1498,12517,1641
1600000US0615044,0615044,"Compton city, California",23392,1920,13029,1403,10363,1371
1600000US0616000,0616000,"Concord city, California",45238,2401,29003,2069,16235,2017
1600000US0616350,0616350,"Corona city, California",45542,3091,32881,2423,12661,1837
1600000US0616532,0616532,"Costa Mesa city, California",40816,2273,16263,1397,24553,2312
1600000US0617918,0617918,"Daly City city, California",30236,2042,17756,1642,12480,1623
1600000US0619766,0619766,"Downey city, California",32736,2398,17885,1822,14851,1945
1600000US0620802,0620802,"East Los Angeles CDP, California",29987,2209,10191,1251,19796,2139
1600000US0621712,0621712,"El Cajon city, California",32652,2152,13401,1644,19251,1995
1600000US0622020,0622020,"Elk Grove city, California",43902,2674,35102,2228,8800,1586
1600000US0622230,0622230,"El Monte city, California",26757,1816,11485,1273,15272,1754
1600000US0622804,0622804,"Escondido city, California",43151,2041,23196,1589,19955,2034
1600000US0623182,0623182,"Fairfield city, California",34750,2138,22459,1711,12291,1609
1600000US0624477,0624477,"Florence-Graham CDP, California",14196,1377,5582,994,8614,1237
1600000US0624638,0624638,"Folsom city, California",24928,1497,18403,1391,6525,1141
1600000US0624680,0624680,"Fontana city, California",47904,2712,34029,2059,13875,1765
1600000US0626000,0626000,"Fremont city, California",68752,2804,45811,2407,22941,2136
1600000US0627000,0627000,"Fresno city, California",155026,3567,77839,3252,77187,3713
1600000US0628000,0628000,"Fullerton city, California",44005,2382,24972,1599,19033,2049
1600000US0629000,0629000,"Garden Grove city, California",38920,2345,24664,1802,14256,1768
1600000US0630000,0630000,"Glendale city, California",72951,3055,28388,2258,44563,2751
1600000US0632548,0632548,"Hawthorne city, California",29128,2288,7428,1404,21700,2146
1600000US0633000,0633000,"Hayward city, California",40836,2237,23882,1936,16954,1945
1600000US0633182,0633182,"Hemet city, California",29721,1994,19167,1720,10554,1677
1600000US0633434,0633434,"Hesperia city, California",24806,1853,17600,1633,7206,1352
1600000US0636000,0636000,"Huntington Beach city, California",72756,3109,46943,2433,25813,2420
1600000US0636448,0636448,"Indio city, California",22234,1789,14256,1731,7978,1185
1600000US0636546,0636546,"Inglewood city, California",37080,2436,13473,1658,23607,2047
1600000US0636770,0636770,"Irvine city, California",69990,2718,40573,2016,29417,2575
1600000US0639496,0639496,"Lake Forest city, California",25701,1608,19169,1354,6532,1004
1600000US0639892,0639892,"Lakewood city, California",28122,1862,19930,1589,8192,1406
1600000US0640130,0640130,"Lancaster city, California",45131,2813,28790,2151,16341,2172
1600000US0641992,0641992,"Livermore city, California",28092,1845,20285,1590,7807,1538
1600000US0643000,0643000,"Long Beach city, California",158561,4435,67852,3299,90709,3952
1600000US0644000,0644000,"Los Angeles city, California",1284430,11009,509663,8693,774767,11111
1600000US0644574,0644574,"Lynwood city, California",14745,1416,7970,1142,6775,1216
1600000US0646898,0646898,"Merced city, California",23644,1760,9154,1213,14490,1869
1600000US0647766,0647766,"Milpitas city, California",18395,1172,12473,1174,5922,1240
1600000US0648256,0648256,"Mission Viejo city, California",32820,1531,26752,1542,6068,1070
1600000US0648354,0648354,"Modesto city, California",65526,2860,40210,2750,25316,2235
1600000US0649270,0649270,"Moreno Valley city, California",49016,2458,33474,1961,15542,2013
1600000US0649670,0649670,"Mountain View city, California",30225,1640,13320,1301,16905,1770
1600000US0650076,0650076,"Murrieta city, California",28196,2219,21063,1523,7133,1575
1600000US0650258,0650258,"Napa city, California",27387,1354,16232,1397,11155,1428
1600000US0651182,0651182,"Newport Beach city, California",37815,1957,22618,1604,15197,1415
1600000US0652526,0652526,"Norwalk city, California",28265,2070,19587,1448,8678,1513
1600000US0653000,0653000,"Oakland city, California",147683,3989,66494,2957,81189,4015
1600000US0653322,0653322,"Oceanside city, California",59452,2372,37428,2104,22024,1829
1600000US0653896,0653896,"Ontario city, California",44119,2628,25387,2114,18732,2180
1600000US0653980,0653980,"Orange city, California",42800,2415,28969,1798,13831,1613
1600000US0654652,0654652,"Oxnard city, California",46086,2250,26989,1752,19097,1874
1600000US0655156,0655156,"Palmdale city, California",36425,2438,25428,1935,10997,1491
1600000US0656000,0656000,"Pasadena city, California",51133,2533,24982,1658,26151,2442
1600000US0657792,0657792,"Pleasanton city, California",24939,1545,17603,1378,7336,1309
1600000US0658072,0658072,"Pomona city, California",35861,2338,19562,1608,16299,1854
1600000US0659451,0659451,"Rancho Cucamonga city, California",50630,3227,35152,2911,15478,2048
1600000US0659920,0659920,"Redding city, California",36132,1808,19194,1384,16938,1890
1600000US0659962,0659962,"Redlands city, California",24386,1974,16534,1591,7852,1277
1600000US0660018,0660018,"Redondo Beach city, California",28840,1996,15414,1664,13426,1647
1600000US0660102,0660102,"Redwood City city, California",27276,1803,14955,1175,12321,1763
1600000US0660466,0660466,"Rialto city, California",25744,1784,18018,1664,7726,1373
1600000US0660620,0660620,"Richmond city, California",33457,2203,20153,1662,13304,1741
1600000US0662000,0662000,"Riverside city, California",91878,3606,53397,2899,38481,3048
1600000US0662938,0662938,"Roseville city, California",43733,2091,28456,1729,15277,2082
1600000US0664000,0664000,"Sacramento city, California",170358,4287,89275,3392,81083,3656
1600000US0664224,0664224,"Salinas city, California",39657,2200,19395,1970,20262,1999
1600000US0665000,0665000,"San Bernardino city, California",60579,2670,31636,2389,28943,2457
1600000US0665042,0665042,"San Buenaventura (Ventura) city, California",40089,1893,22408,1741,17681,1838
1600000US0666000,0666000,"San Diego city, California",468469,6880,235174,5208,233295,6216
1600000US0667000,0667000,"San Francisco city, California",321947,3762,121809,4211,200138,4408
1600000US0668000,0668000,"San Jose city, California",290680,4479,179730,4805,110950,4451
1600000US0668084,0668084,"San Leandro city, California",33280,2366,19580,1790,13700,1932
1600000US0668196,0668196,"San Marcos city, California",24259,1781,15420,1273,8839,1606
1600000US0668252,0668252,"San Mateo city, California",35607,1772,19388,1408,16219,1595
1600000US0669000,0669000,"Santa Ana city, California",74972,2731,37290,2253,37682,2876
1600000US0669070,0669070,"Santa Barbara city, California",35679,2082,15323,1467,20356,1966
1600000US0669084,0669084,"Santa Clara city, California",39069,2238,18328,1560,20741,1958
1600000US0669088,0669088,"Santa Clarita city, California",58761,2861,42800,2227,15961,1947
1600000US0669196,0669196,"Santa Maria city, California",25346,1708,12944,1384,12402,1458
1600000US0670000,0670000,"Santa Monica city, California",45843,2694,12774,1624,33069,2662
1600000US0670098,0670098,"Santa Rosa city, California",58550,2779,32368,1870,26182,2338
1600000US0672016,0672016,"Simi Valley city, California",39466,1942,29451,1812,10015,1228
1600000US0673080,0673080,"South Gate city, California",24361,1734,10096,1311,14265,1589
1600000US0675000,0675000,"Stockton city, California",89609,2872,49327,2653,40282,3301
1600000US0677000,0677000,"Sunnyvale city, California",51319,2304,25115,1603,26204,2347
1600000US0678120,0678120,"Temecula city, California",29943,2478,21144,1798,8799,1670
1600000US0678582,0678582,"Thousand Oaks city, California",44598,2155,34254,1834,10344,1632
1600000US0680000,0680000,"Torrance city, California",54934,2752,31955,2012,22979,2484
1600000US0680238,0680238,"Tracy city, California",24483,1876,17059,1812,7424,1439
1600000US0680812,0680812,"Turlock city, California",22933,1777,13395,1395,9538,1385
1600000US0680854,0680854,"Tustin city, California",22435,1599,12808,1240,9627,1307
1600000US0681204,0681204,"Union City city, California",19291,1491,13942,1258,5349,1177
1600000US0681344,0681344,"Upland city, California",26918,2207,15489,1558,11429,1842
1600000US0681554,0681554,"Vacaville city, California",30262,1808,20368,1560,9894,1457
1600000US0681666,0681666,"Vallejo city, California",36650,1888,24024,1773,12626,1529
1600000US0682590,0682590,"Victorville city, California",27376,2227,18683,2104,8693,1515
1600000US0682954,0682954,"Visalia city, California",37374,2441,22946,1921,14428,1952
1600000US0682996,0682996,"Vista city, California",29806,1944,15779,1481,14027,1652
1600000US0684200,0684200,"West Covina city, California",31163,2022,21302,1974,9861,1450
1600000US0684550,0684550,"Westminster city, California",27454,1768,16162,1447,11292,1395
1600000US0685292,0685292,"Whittier city, California",27099,1899,16641,1778,10458,1351
1600000US0686832,0686832,"Yorba Linda city, California",19174,1285,16016,1101,3158,849
1600000US0803455,0803455,"Arvada city, Colorado",42442,2129,31376,1974,11066,1463
1600000US0804000,0804000,"Aurora city, Colorado",115617,3064,72298,2757,43319,3255
1600000US0807850,0807850,"Boulder city, Colorado",37920,2034,20270,1727,17650,1811
1600000US0812815,0812815,"Centennial city, Colorado",37800,1514,31735,1528,6065,1143
1600000US0816000,0816000,"Colorado Springs city, Colorado",153978,3130,98800,3212,55178,2778
1600000US0820000,0820000,"Denver city, Colorado",246335,3214,139101,3426,107234,4194
1600000US0827425,0827425,"Fort Collins city, Colorado",53253,2319,32405,1676,20848,2067
1600000US0832155,0832155,"Greeley city, Colorado",31790,2225,19482,1639,12308,1628
1600000US0836410,0836410,"Highlands Ranch CDP, Colorado",30467,1546,26689,1500,3778,964
1600000US0843000,0843000,"Lakewood city, Colorado",60983,2285,38398,2338,22585,2281
1600000US0845970,0845970,"Longmont city, Colorado",33377,1801,21380,1659,11997,1521
1600000US0862000,0862000,"Pueblo city, Colorado",40100,1647,26879,1479,13221,1567
1600000US0877290,0877290,"Thornton city, Colorado",37869,2348,29186,1824,8683,1495
1600000US0883835,0883835,"Westminster city, Colorado",41329,2193,27942,1745,13387,1759
1600000US0908000,0908000,"Bridgeport city, Connecticut",46579,2702,22673,2069,23906,2144
1600000US0918430,0918430,"Danbury city, Connecticut",30646,1839,18503,1323,12143,1707
1600000US0937000,0937000,"Hartford city, Connecticut",43486,2573,10336,1268,33150,2470
1600000US0950370,0950370,"New Britain city, Connecticut",26204,2112,12200,1309,14004,1882
1600000US0952000,0952000,"New Haven city, Connecticut",46713,2537,16028,1898,30685,2346
1600000US0955990,0955990,"Norwalk city, Connecticut",32812,2049,20470,1546,12342,1831
1600000US0973000,0973000,"Stamford city, Connecticut",45739,2412,27792,1784,17947,1969
1600000US0980000,0980000,"Waterbury city, Connecticut",43624,2682,21548,2034,22076,2320
1600000US1077580,1077580,"Wilmington city, Delaware",28804,1966,13452,1276,15352,1754
1600000US1150000,1150000,"Washington city, District of Columbia",251039,2911,111813,2883,139226,3601
1600000US1207300,1207300,"Boca Raton city, Florida",35750,1981,26222,1695,9528,1347
1600000US1207875,1207875,"Boynton Beach city, Florida",27860,1878,19483,1890,8377,1483
1600000US1208150,1208150,"Brandon CDP, Florida",35179,1992,23699,1773,11480,1768
1600000US1210275,1210275,"Cape Coral city, Florida",59172,3227,43695,3005,15477,2288
1600000US1212875,1212875,"Clearwater city, Florida",44637,2412,28328,1845,16309,1916
1600000US1214400,1214400,"Coral Springs city, Florida",41025,2652,28285,2004,12740,1583
1600000US1216475,1216475,"Davie town, Florida",36931,2328,27404,2363,9527,1541
1600000US1216725,1216725,"Deerfield Beach city, Florida",33543,2564,24367,2189,9176,1684
1600000US1217200,1217200,"Deltona city, Florida",30972,2447,27612,2389,3360,1121
1600000US1224000,1224000,"Fort Lauderdale city, Florida",69076,3508,43628,2848,25448,2524
1600000US1225175,1225175,"Gainesville city, Florida",44943,2150,18500,1689,26443,1723
1600000US1230000,1230000,"Hialeah city, Florida",73828,3525,37921,2305,35907,3258
1600000US1232000,1232000,"Hollywood city, Florida",56279,3138,36097,2656,20182,2333
1600000US1235000,1235000,"Jacksonville city, Florida",321570,4871,209565,4421,112005,5101
1600000US1236100,1236100,"Kendall CDP, Florida",29431,2375,20169,2131,9262,1830
1600000US1238250,1238250,"Lakeland city, Florida",40346,2635,24174,1995,16172,1948
1600000US1239425,1239425,"Largo city, Florida",36242,2359,22072,1611,14170,2015
1600000US1239550,1239550,"Lauderhill city, Florida",24317,2040,14578,1820,9739,1487
1600000US1239925,1239925,"Lehigh Acres CDP, Florida",23890,1640,19226,1527,4664,1217
1600000US1243975,1243975,"Melbourne city, Florida",32155,2198,20190,1394,11965,2046
1600000US1245000,1245000,"Miami city, Florida",136274,4617,51052,3175,85222,4366
1600000US1245025,1245025,"Miami Beach city, Florida",39515,2799,19030,1963,20485,2274
1600000US1245060,1245060,"Miami Gardens city, Florida",34746,2625,24925,2657,9821,1571
1600000US1245975,1245975,"Miramar city, Florida",34355,2338,28762,2259,5593,1320
1600000US1253000,1253000,"Orlando city, Florida",91357,3626,38624,2106,52733,3457
1600000US1254000,1254000,"Palm Bay city, Florida",35986,2121,28618,2007,7368,1359
1600000US1254200,1254200,"Palm Coast city, Florida",29230,2216,22129,1944,7101,1624
1600000US1255775,1255775,"Pembroke Pines city, Florida",54821,2737,45187,2555,9634,1519
1600000US1257425,1257425,"Plantation city, Florida",33295,2016,25272,1850,8023,1392
1600000US1258050,1258050,"Pompano Beach city, Florida",43198,2717,27299,2016,15899,2098
1600000US1258715,1258715,"Port St. Lucie city, Florida",57228,2749,44281,2316,12947,1796
1600000US1263000,1263000,"St. Petersburg city, Florida",102685,3017,67742,2956,34943,2865
1600000US1268350,1268350,"Spring Hill CDP, Florida",35609,2003,30560,1739,5049,1301
1600000US1269700,1269700,"Sunrise city, Florida",30467,2043,24263,1930,6204,1182
1600000US1270600,1270600,"Tallahassee city, Florida",68682,2715,30112,1783,38570,2555
1600000US1271000,1271000,"Tampa city, Florida",129827,4246,74943,3308,54884,4348
1600000US1272145,1272145,"Town 'n' Country CDP, Florida",30435,2348,20402,1884,10033,1530
1600000US1276582,1276582,"Weston city, Florida",19929,1806,16424,1560,3505,1165
1600000US1276600,1276600,"West Palm Beach city, Florida",35538,2319,20681,1851,14857,1666
1600000US1301052,1301052,"Albany city, Georgia",29176,1432,11937,1213,17239,1570
1600000US1303440,1303440,"Athens-Clarke County unified government (balance), Georgia",43105,1279,20110,1461,22995,1506
1600000US1304000,1304000,"Atlanta city, Georgia",167833,4340,88012,3516,79821,3963
1600000US1304204,1304204,"Augusta-Richmond County consolidated government (balance), Georgia",72190,1945,41062,1991,31128,1978
1600000US1319000,1319000,"Columbus city, Georgia",71362,1982,40829,2391,30533,2689
1600000US1349000,1349000,"Macon city, Georgia",35554,1948,18411,1492,17143,1609
1600000US1349756,1349756,"Marietta city, Georgia",23044,2167,10367,1201,12677,1956
1600000US1367284,1367284,"Roswell city, Georgia",37083,1808,26862,1633,10221,1600
1600000US1368516,1368516,"Sandy Springs city, Georgia",43411,2954,23117,1818,20294,2794
1600000US1369000,1369000,"Savannah city, Georgia",50360,2583,24456,2011,25904,2275
1600000US1517000,1517000,"Honolulu CDP, Hawaii",143851,3794,73223,3012,70628,3569
1600000US1608830,1608830,"Boise City city, Idaho",83317,2745,53487,2417,29830,2562
1600000US1656260,1656260,"Nampa city, Idaho",28967,1597,19506,1685,9461,1498
1600000US1702154,1702154,"Arlington Heights village, Illinois",30707,1547,23646,1185,7061,1328
1600000US1703012,1703012,"Aurora city, Illinois",60435,2827,45868,2407,14567,2114
1600000US1706613,1706613,"Bloomington city, Illinois",29669,1294,19583,1078,10086,1274
1600000US1707133,1707133,"Bolingbrook village, Illinois",21103,1690,17836,1541,3267,1097
1600000US1712385,1712385,"Champaign city, Illinois",31447,1697,14729,1161,16718,1627
1600000US1714000,1714000,"Chicago city, Illinois",1022916,11190,510581,7936,512335,10373
1600000US1714351,1714351,"Cicero town, Illinois",21851,1984,11844,1618,10007,1455
1600000US1718823,1718823,"Decatur city, Illinois",31568,1505,20480,1669,11088,1407
1600000US1723074,1723074,"Elgin city, Illinois",35349,2187,23519,1912,11830,1617
1600000US1724582,1724582,"Evanston city, Illinois",26299,1734,15917,1365,10382,1458
1600000US1738570,1738570,"Joliet city, Illinois",47290,2195,35495,1970,11795,1916
1600000US1751622,1751622,"Naperville city, Illinois",47601,2424,38561,1802,9040,1642
1600000US1757225,1757225,"Palatine village, Illinois",27155,1772,19829,1478,7326,1435
1600000US1759000,1759000,"Peoria city, Illinois",46507,2077,27202,1669,19305,2110
1600000US1765000,1765000,"Rockford city, Illinois",57115,1924,36667,1717,20448,1596
1600000US1768003,1768003,"Schaumburg village, Illinois",30083,2099,20739,1538,9344,1619
1600000US1770122,1770122,"Skokie village, Illinois",23181,1715,18173,1831,5008,1149
1600000US1772000,1772000,"Springfield city, Illinois",50610,1749,31592,1460,19018,1651
1600000US1779293,1779293,"Waukegan city, Illinois",27893,2046,15429,1490,12464,1784
1600000US1805860,1805860,"Bloomington city, Indiana",28515,1382,10046,1014,18469,1447
1600000US1822000,1822000,"Evansville city, Indiana",47802,1600,28168,1862,19634,1925
1600000US1823278,1823278,"Fishers town, Indiana",22911,1562,17862,1365,5049,1237
1600000US1825000,1825000,"Fort Wayne city, Indiana",99817,2325,65072,2263,34745,2677
1600000US1827000,1827000,"Gary city, Indiana",32147,2574,17925,1608,14222,2218
1600000US1831000,1831000,"Hammond city, Indiana",30006,2007,18435,1389,11571,1735
1600000US1836003,1836003,"Indianapolis city (balance), Indiana",323177,3996,196639,4367,126538,4163
1600000US1851876,1851876,"Muncie city, Indiana",27351,1410,14410,1113,12941,1578
1600000US1871000,1871000,"South Bend city, Indiana",39013,1845,24678,1788,14335,1860
1600000US1912000,1912000,"Cedar Rapids city, Iowa",56624,1634,38484,1933,18140,1768
1600000US1919000,1919000,"Davenport city, Iowa",38773,1530,25080,1438,13693,1348
1600000US1921000,1921000,"Des Moines city, Iowa",81201,2421,54000,1925,27201,1890
1600000US1938595,1938595,"Iowa City city, Iowa",27239,1355,14308,1136,12931,1211
1600000US1973335,1973335,"Sioux City city, Iowa",31290,1262,20901,1333,10389,1354
1600000US1982425,1982425,"Waterloo city, Iowa",27224,1485,18569,1274,8655,1356
1600000US2036000,2036000,"Kansas City city, Kansas",53422,1613,32737,1741,20685,1673
1600000US2038900,2038900,"Lawrence city, Kansas",35506,1271,18529,1467,16977,1671
1600000US2052575,2052575,"Olathe city, Kansas",41344,1948,30059,1386,11285,1543
1600000US2053775,2053775,"Overland Park city, Kansas",65559,2311,44100,1795,21459,2022
1600000US2071000,2071000,"Topeka city, Kansas",53628,1484,31962,1756,21666,1938
1600000US2079000,2079000,"Wichita city, Kansas",145496,2611,94234,2739,51262,3399
1600000US2146027,2146027,"Lexington-Fayette urban county, Kentucky",119815,2365,70286,2615,49529,2678
1600000US2148006,2148006,"Louisville/Jefferson County metro government (balance), Kentucky",230572,3806,151636,3598,78936,3716
1600000US2205000,2205000,"Baton Rouge city, Louisiana",92074,3163,47093,2546,44981,2544
1600000US2239475,2239475,"Kenner city, Louisiana",22925,1876,12925,1412,10000,1647
1600000US2240735,2240735,"Lafayette city, Louisiana",49156,2125,28133,1595,21023,2127
1600000US2241155,2241155,"Lake Charles city, Louisiana",29238,1706,16256,1353,12982,1722
1600000US2250115,2250115,"Metairie CDP, Louisiana",53436,2511,33847,2165,19589,1883
1600000US2255000,2255000,"New Orleans city, Louisiana",80039,3114,41274,2355,38765,2616
1600000US2270000,2270000,"Shreveport city, Louisiana",79384,2178,45519,2305,33865,2746
1600000US2404000,2404000,"Baltimore city, Maryland",233013,3843,119820,3887,113193,4602
1600000US2419125,2419125,"Columbia CDP, Maryland",35956,1646,26120,1553,9836,1564
1600000US2472450,2472450,"Silver Spring CDP, Maryland",29259,1789,13825,1314,15434,1712
1600000US2507000,2507000,"Boston city, Massachusetts",229787,3717,88534,3762,141253,5078
1600000US2509000,2509000,"Brockton city, Massachusetts",32523,2100,19153,2008,13370,1961
1600000US2511000,2511000,"Cambridge city, Massachusetts",42180,2258,16241,1577,25939,2174
1600000US2523000,2523000,"Fall River city, Massachusetts",37741,2301,13406,1485,24335,2231
1600000US2524960,2524960,"Framingham CDP, Massachusetts",25967,1670,15285,1355,10682,1583
1600000US2534550,2534550,"Lawrence city, Massachusetts",23017,1949,8366,1354,14651,1740
1600000US2537000,2537000,"Lowell city, Massachusetts",36584,2466,17899,1675,18685,2123
1600000US2537490,2537490,"Lynn city, Massachusetts",33549,2315,16198,1719,17351,2034
1600000US2545000,2545000,"New Bedford city, Massachusetts",37794,2173,17209,1544,20585,2072
1600000US2545560,2545560,"Newton city, Massachusetts",33948,1979,23962,1584,9986,1625
1600000US2555745,2555745,"Quincy city, Massachusetts",37537,2094,19014,1653,18523,2084
1600000US2562535,2562535,"Somerville city, Massachusetts",29759,2219,11028,1419,18731,2280
1600000US2567000,2567000,"Springfield city, Massachusetts",55612,2597,27789,2098,27823,2302
1600000US2582000,2582000,"Worcester city, Massachusetts",65980,3237,32848,2470,33132,2808
1600000US2603000,2603000,"Ann Arbor city, Michigan",45245,2047,23507,1359,21738,1814
1600000US2613110,2613110,"Canton CDP, Michigan",31637,1795,25035,1633,6602,1201
1600000US2616510,2616510,"Clinton CDP, Michigan",41598,2146,28795,1698,12803,1673
1600000US2621000,2621000,"Dearborn city, Michigan",34706,1951,24597,1674,10109,1466
1600000US2622000,2622000,"Detroit city, Michigan",277389,4613,153708,3793,123681,4390
1600000US2627440,2627440,"Farmington Hills city, Michigan",34142,1791,22636,1544,11506,1513
1600000US2629000,2629000,"Flint city, Michigan",41780,1979,24524,1702,17256,1822
1600000US2634000,2634000,"Grand Rapids city, Michigan",72224,2335,44512,2218,27712,2238
1600000US2642160,2642160,"Kalamazoo city, Michigan",26876,1972,11653,944,15223,2055
1600000US2646000,2646000,"Lansing city, Michigan",48177,2006,27474,1596,20703,1983
1600000US2649000,2649000,"Livonia city, Michigan",36985,1478,33376,1490,3609,743
1600000US2665440,2665440,"Pontiac city, Michigan",22426,1815,11727,1400,10699,1407
1600000US2669035,2669035,"Rochester Hills city, Michigan",29080,1298,22786,1248,6294,1129
1600000US2672818,2672818,"Shelby CDP, Michigan",28496,1559,22947,1365,5549,1109
1600000US2674900,2674900,"Southfield city, Michigan",31705,1985,18685,1449,13020,1580
1600000US2676460,2676460,"Sterling Heights city, Michigan",49250,2096,39148,1621,10102,1379
1600000US2680700,2680700,"Troy city, Michigan",31127,1631,24747,1104,6380,1171
1600000US2684000,2684000,"Warren city, Michigan",52884,2332,41471,1949,11413,1448
1600000US2684220,2684220,"Waterford CDP, Michigan",31317,1614,22656,1334,8661,1466
1600000US2685510,2685510,"West Bloomfield Township CDP, Michigan",24884,1259,21454,1197,3430,700
1600000US2686000,2686000,"Westland city, Michigan",34592,2115,23689,1630,10903,1509
1600000US2688940,2688940,"Wyoming city, Michigan",28153,1947,20247,1742,7906,1461
1600000US2706616,2706616,"Bloomington city, Minnesota",34634,1633,25111,1155,9523,1619
1600000US2707966,2707966,"Brooklyn Park city, Minnesota",24817,1565,18711,1445,6106,1225
1600000US2717000,2717000,"Duluth city, Minnesota",36897,1686,22221,1106,14676,1299
1600000US2743000,2743000,"Minneapolis city, Minnesota",156626,3878,82579,3105,74047,3547
1600000US2751730,2751730,"Plymouth city, Minnesota",28245,1457,21349,1169,6896,1208
1600000US2754880,2754880,"Rochester city, Minnesota",39736,1344,28627,1258,11109,1450
1600000US2756896,2756896,"St. Cloud city, Minnesota",25547,1509,13990,1219,11557,1254
1600000US2758000,2758000,"St. Paul city, Minnesota",108057,2665,60841,2445,47216,2473
1600000US2829700,2829700,"Gulfport city, Mississippi",24877,2014,15867,1689,9010,1448
1600000US2836000,2836000,"Jackson city, Mississippi",64245,2315,35079,2643,29166,2549
1600000US2915670,2915670,"Columbia city, Missouri",40856,1907,19825,1435,21031,1870
1600000US2935000,2935000,"Independence city, Missouri",47122,2285,32726,1860,14396,1799
1600000US2938000,2938000,"Kansas City city, Missouri",184187,4115,105331,3516,78856,3790
1600000US2941348,2941348,"Lee's Summit city, Missouri",33379,2008,26413,1536,6966,1395
1600000US2954074,2954074,"O'Fallon city, Missouri",24808,1459,22179,1522,2629,755
1600000US2964550,2964550,"St. Joseph city, Missouri",28538,1143,18607,1179,9931,1063
1600000US2965000,2965000,"St. Louis city, Missouri",141559,3208,71725,2857,69834,3190
1600000US2970000,2970000,"Springfield city, Missouri",68542,1975,36339,1810,32203,2067
1600000US3006550,3006550,"Billings city, Montana",39700,1315,26488,1396,13212,1567
1600000US3050200,3050200,"Missoula city, Montana",26131,1259,13881,1207,12250,1385
1600000US3128000,3128000,"Lincoln city, Nebraska",99514,1758,60834,2132,38680,2461
1600000US3137000,3137000,"Omaha city, Nebraska",149107,2942,89386,2440,59721,3108
1600000US3223770,3223770,"Enterprise CDP, Nevada",27974,1994,17415,1746,10559,1399
1600000US3231900,3231900,"Henderson city, Nevada",96252,3650,65217,2671,31035,2931
1600000US3240000,3240000,"Las Vegas city, Nevada",209189,5710,120816,4593,88373,4917
1600000US3251800,3251800,"North Las Vegas city, Nevada",63983,2881,39942,2302,24041,2599
1600000US3254600,3254600,"Paradise CDP, Nevada",82940,3711,36974,2228,45966,3108
1600000US3260600,3260600,"Reno city, Nevada",83623,2965,41052,2167,42571,2902
1600000US3268400,3268400,"Sparks city, Nevada",30699,1794,18752,1669,11947,1776
1600000US3268585,3268585,"Spring Valley CDP, Nevada",68751,3670,37542,2086,31209,2981
1600000US3271400,3271400,"Sunrise Manor CDP, Nevada",62909,3451,37959,2256,24950,2780
1600000US3345140,3345140,"Manchester city, New Hampshire",45481,2059,22466,1822,23015,1924
1600000US3350260,3350260,"Nashua city, New Hampshire",33365,2012,20108,1531,13257,1687
1600000US3410000,3410000,"Camden city, New Jersey",24860,1760,10687,1381,14173,1463
1600000US3413690,3413690,"Clifton city, New Jersey",30559,2226,19245,2045,11314,1525
1600000US3419390,3419390,"East Orange city, New Jersey",23267,1844,6227,1088,17040,1750
1600000US3420260,3420260,"Edison CDP, New Jersey",34461,1898,21268,1665,13193,1787
1600000US3421000,3421000,"Elizabeth city, New Jersey",41527,2553,10291,1716,31236,2742
1600000US3436000,3436000,"Jersey City city, New Jersey",85550,3070,29014,2140,56536,2746
1600000US3451000,3451000,"Newark city, New Jersey",90180,3601,25875,2284,64305,3066
1600000US3456550,3456550,"Passaic city, New Jersey",19432,1825,5461,1108,13971,1861
1600000US3457000,3457000,"Paterson city, New Jersey",41890,2136,11900,1745,29990,2050
1600000US3473110,3473110,"Toms River CDP, New Jersey",30863,1495,25499,1521,5364,928
1600000US3474000,3474000,"Trenton city, New Jersey",25620,2057,12283,1408,13337,1773
1600000US3474630,3474630,"Union City city, New Jersey",22170,1775,4857,968,17313,1663
1600000US3502000,3502000,"Albuquerque city, New Mexico",209520,3591,129054,3531,80466,3795
1600000US3539380,3539380,"Las Cruces city, New Mexico",36970,2097,20190,1795,16780,2105
1600000US3563460,3563460,"Rio Rancho city, New Mexico",26132,1175,22211,1334,3921,1049
1600000US3570500,3570500,"Santa Fe city, New Mexico",26377,1606,16100,1514,10277,1545
1600000US3601000,3601000,"Albany city, New York",38639,1976,15637,1431,23002,1875
1600000US3611000,3611000,"Buffalo city, New York",113225,3681,51329,2900,61896,3945
1600000US3615000,3615000,"Cheektowaga CDP, New York",33763,1512,24217,1455,9546,1532
1600000US3649121,3649121,"Mount Vernon city, New York",23606,1737,8156,1049,15450,1645
1600000US3650617,3650617,"New Rochelle city, New York",26075,1818,13467,1285,12608,1556
1600000US3651000,3651000,"New York city, New York",3030752,9891,1019340,11580,2011412,13623
1600000US3663000,3663000,"Rochester city, New York",82047,2509,33040,2134,49007,2688
1600000US3673000,3673000,"Syracuse city, New York",54152,2276,22309,1534,31843,2453
1600000US3684000,3684000,"Yonkers city, New York",71501,2956,34271,1919,37230,2687
1600000US3702140,3702140,"Asheville city, North Carolina",35168,2027,19048,1689,16120,1816
1600000US3710740,3710740,"Cary town, North Carolina",44563,2326,31260,1917,13303,1898
1600000US3712000,3712000,"Charlotte city, North Carolina",276735,4654,165248,4249,111487,4405
1600000US3719000,3719000,"Durham city, North Carolina",87031,2261,44807,2021,42224,2543
1600000US3722920,3722920,"Fayetteville city, North Carolina",66473,2659,39141,2232,27332,2185
1600000US3725580,3725580,"Gastonia city, North Carolina",26891,1715,14642,1654,12249,1453
1600000US3728000,3728000,"Greensboro city, North Carolina",102357,2976,53886,2497,48471,3060
1600000US3728080,3728080,"Greenville city, North Carolina",33428,2118,11676,1404,21752,1910
1600000US3731400,3731400,"High Point city, North Carolina",38926,2383,23538,1839,15388,1923
1600000US3734200,3734200,"Jacksonville city, North Carolina",16630,1842,7304,1174,9326,1597
1600000US3755000,3755000,"Raleigh city, North Carolina",144789,3556,79877,3107,64912,3447
1600000US3774440,3774440,"Wilmington city, North Carolina",43784,1882,22179,1499,21605,1896
1600000US3775000,3775000,"Winston-Salem city, North Carolina",87128,3156,50711,2795,36417,3001
1600000US3825700,3825700,"Fargo city, North Dakota",43838,1463,18746,1364,25092,1728
1600000US3901000,3901000,"Akron city, Ohio",82878,2730,47774,2571,35104,2567
1600000US3912000,3912000,"Canton city, Ohio",31553,1851,18237,1652,13316,1708
1600000US3915000,3915000,"Cincinnati city, Ohio",127971,3266,55087,2738,72884,2888
1600000US3916000,3916000,"Cleveland city, Ohio",165418,4316,77178,3024,88240,4225
1600000US3918000,3918000,"Columbus city, Ohio",306775,4459,159127,4498,147648,4816
1600000US3921000,3921000,"Dayton city, Ohio",61423,2824,30436,2142,30987,2437
1600000US3944856,3944856,"Lorain city, Ohio",24564,1712,15214,1560,9350,1404
1600000US3961000,3961000,"Parma city, Ohio",34107,1712,25428,1257,8679,1437
1600000US3977000,3977000,"Toledo city, Ohio",117939,2953,70820,2624,47119,2905
1600000US3988000,3988000,"Youngstown city, Ohio",27009,1414,16291,1289,10718,1312
1600000US4009050,4009050,"Broken Arrow city, Oklahoma",33462,1716,26418,1592,7044,1281
1600000US4023200,4023200,"Edmond city, Oklahoma",30184,1626,21937,1474,8247,1407
1600000US4041850,4041850,"Lawton city, Oklahoma",32944,1300,19170,1305,13774,1339
1600000US4052500,4052500,"Norman city, Oklahoma",42516,2113,24663,1701,17853,1697
1600000US4055000,4055000,"Oklahoma City city, Oklahoma",220397,3744,135994,4407,84403,3733
1600000US4075000,4075000,"Tulsa city, Oklahoma",165998,3189,92495,2936,73503,3588
1600000US4105350,4105350,"Beaverton city, Oregon",35129,2118,17823,1654,17306,1827
1600000US4105800,4105800,"Bend city, Oregon",30617,1896,18032,1527,12585,1790
1600000US4123850,4123850,"Eugene city, Oregon",64575,2384,34825,2272,29750,2376
1600000US4131250,4131250,"Gresham city, Oregon",36097,2133,22291,2014,13806,1656
1600000US4134100,4134100,"Hillsboro city, Oregon",30460,1732,15692,1351,14768,1641
1600000US4147000,4147000,"Medford city, Oregon",31182,1959,17198,1305,13984,1775
1600000US4159000,4159000,"Portland city, Oregon",238091,3533,136705,3869,101386,3583
1600000US4164900,4164900,"Salem city, Oregon",57292,2577,32119,2087,25173,2237
1600000US4202000,4202000,"Allentown city, Pennsylvania",39976,1668,19268,1699,20708,1777
1600000US4206088,4206088,"Bethlehem city, Pennsylvania",29018,1979,15690,1475,13328,1559
1600000US4224000,4224000,"Erie city, Pennsylvania",38057,1755,21978,1358,16079,1767
1600000US4260000,4260000,"Philadelphia city, Pennsylvania",562384,5742,323021,6508,239363,6884
1600000US4261000,4261000,"Pittsburgh city, Pennsylvania",130540,3790,70262,2785,60278,3345
1600000US4263624,4263624,"Reading city, Pennsylvania",28244,1752,13666,1420,14578,1637
1600000US4269000,4269000,"Scranton city, Pennsylvania",29713,1620,16220,1324,13493,1363
1600000US4419180,4419180,"Cranston city, Rhode Island",30983,1673,21474,1603,9509,1358
1600000US4454640,4454640,"Pawtucket city, Rhode Island",28561,1995,12874,1393,15687,1818
1600000US4459000,4459000,"Providence city, Rhode Island",58704,2750,21106,1716,37598,2640
1600000US4474300,4474300,"Warwick city, Rhode Island",36036,1528,27429,1522,8607,1181
1600000US4513330,4513330,"Charleston city, South Carolina",48041,2846,26613,2174,21428,2157
1600000US4516000,4516000,"Columbia city, South Carolina",41932,2470,20360,1743,21572,2142
1600000US4550875,4550875,"North Charleston city, South Carolina",34162,2399,16644,1670,17518,2041
1600000US4659020,4659020,"Sioux Falls city, South Dakota",57845,1860,36210,1701,21635,2060
1600000US4714000,4714000,"Chattanooga city, Tennessee",67674,2271,37618,2275,30056,2003
1600000US4715160,4715160,"Clarksville city, Tennessee",45705,1731,28004,1600,17701,2039
1600000US4740000,4740000,"Knoxville city, Tennessee",84045,3109,43906,2493,40139,3330
1600000US4748000,4748000,"Memphis city, Tennessee",250885,4727,133321,4242,117564,5144
1600000US4751560,4751560,"Murfreesboro city, Tennessee",37872,2292,22089,1825,15783,1797
1600000US4752006,4752006,"Nashville-Davidson metropolitan government (balance), Tennessee",240698,3589,144496,3963,96202,3860
1600000US4801000,4801000,"Abilene city, Texas",43041,1465,25625,2318,17416,2077
1600000US4801924,4801924,"Allen city, Texas",24932,1554,21210,1268,3722,1137
1600000US4803000,4803000,"Amarillo city, Texas",68686,2012,42588,2008,26098,2073
1600000US4804000,4804000,"Arlington city, Texas",130513,4257,76141,2748,54372,4615
1600000US4804462,4804462,"Atascocita CDP, Texas",19488,1878,16713,1694,2775,935
1600000US4805000,4805000,"Austin city, Texas",306693,4407,141240,4244,165453,4514
1600000US4806128,4806128,"Baytown city, Texas",23061,2065,13907,1605,9154,1497
1600000US4807000,4807000,"Beaumont city, Texas",42990,2078,25163,1900,17827,1746
1600000US4810768,4810768,"Brownsville city, Texas",53704,2533,34846,2241,18858,2262
1600000US4810912,4810912,"Bryan city, Texas",24444,1756,13068,1648,11376,1590
1600000US4813024,4813024,"Carrollton city, Texas",40179,2599,26226,1916,13953,2064
1600000US4815976,4815976,"College Station city, Texas",30728,1927,10695,1250,20033,1793
1600000US4817000,4817000,"Corpus Christi city, Texas",105868,2413,64610,2494,41258,2500
1600000US4819000,4819000,"Dallas city, Texas",451847,6854,213966,4988,237881,6410
1600000US4819972,4819972,"Denton city, Texas",35410,2516,17337,1721,18073,1923
1600000US4822660,4822660,"Edinburg city, Texas",20111,2047,11471,1400,8640,1503
1600000US4824000,4824000,"El Paso city, Texas",199115,3141,124445,3146,74670,3591
1600000US4826232,4826232,"Flower Mound town, Texas",20443,1398,19102,1276,1341,563
1600000US4827000,4827000,"Fort Worth city, Texas",228541,4320,136070,4121,92471,4174
1600000US4827684,4827684,"Frisco city, Texas",31612,2325,25200,1764,6412,1446
1600000US4829000,4829000,"Garland city, Texas",76267,3575,51515,2927,24752,2464
1600000US4830464,4830464,"Grand Prairie city, Texas",52617,2944,32386,2067,20231,2062
1600000US4835000,4835000,"Houston city, Texas",748024,9041,354763,6853,393261,8328
1600000US4837000,4837000,"Irving city, Texas",77708,3097,32866,1758,44842,3333
1600000US4839148,4839148,"Killeen city, Texas",38327,2183,21282,1816,17045,1978
1600000US4841464,4841464,"Laredo city, Texas",59330,1486,38119,1745,21211,1852
1600000US4841980,4841980,"League City city, Texas",25938,1973,19433,1840,6505,1468
1600000US4842508,4842508,"Lewisville city, Texas",31926,2434,16629,2001,15297,2017
1600000US4843888,4843888,"Longview city, Texas",31029,1551,17114,1368,13915,1519
1600000US4845000,4845000,"Lubbock city, Texas",84320,2616,48170,2515,36150,2504
1600000US4845384,4845384,"McAllen city, Texas",41064,2670,25228,2064,15836,2298
1600000US4845744,4845744,"McKinney city, Texas",39077,2217,29594,1769,9483,1558
1600000US4847892,4847892,"Mesquite city, Texas",44266,2384,28472,1930,15794,1809
1600000US4848072,4848072,"Midland city, Texas",39320,1509,26069,1595,13251,1363
1600000US4848768,4848768,"Mission city, Texas",22597,2213,16628,1555,5969,1631
1600000US4848804,4848804,"Missouri City city, Texas",18109,1238,17255,1271,854,374
1600000US4853388,4853388,"Odessa city, Texas",34046,1732,23142,1434,10904,1508
1600000US4856000,4856000,"Pasadena city, Texas",49999,2614,27304,2212,22695,2244
1600000US4856348,4856348,"Pearland city, Texas",27363,2000,21908,1851,5455,1459
1600000US4858016,4858016,"Plano city, Texas",92864,2541,64056,2499,28808,2224
1600000US4861796,4861796,"Richardson city, Texas",36684,2324,24362,1772,12322,1843
1600000US4863500,4863500,"Round Rock city, Texas",29739,1649,19478,1512,10261,1588
1600000US4864472,4864472,"San Angelo city, Texas",35180,1374,24299,1503,10881,1522
1600000US4865000,4865000,"San Antonio city, Texas",444352,5975,262783,5684,181569,6399
1600000US4870808,4870808,"Sugar Land city, Texas",21304,1643,16544,1464,4760,949
1600000US4872656,4872656,"The Woodlands CDP, Texas",21458,1399,15417,1080,6041,1305
1600000US4874144,4874144,"Tyler city, Texas",34426,1607,19468,1412,14958,1465
1600000US4876000,4876000,"Waco city, Texas",42085,2022,19745,1622,22340,1972
1600000US4879000,4879000,"Wichita Falls city, Texas",37392,1729,22745,1307,14647,1741
1600000US4955980,4955980,"Ogden city, Utah",29523,1980,16646,1605,12877,1871
1600000US4957300,4957300,"Orem city, Utah",25413,1485,17025,1140,8388,1254
1600000US4962470,4962470,"Provo city, Utah",32180,1750,14774,1273,17406,1722
1600000US4965330,4965330,"St. George city, Utah",25545,1755,16983,1504,8562,1384
1600000US4967000,4967000,"Salt Lake City city, Utah",74502,2470,36261,1875,38241,2476
1600000US4967440,4967440,"Sandy city, Utah",28529,1581,23851,1515,4678,1051
1600000US4982950,4982950,"West Jordan city, Utah",28732,1744,22267,1398,6465,1083
1600000US4983470,4983470,"West Valley City city, Utah",36247,1892,24727,1633,11520,1738
1600000US5101000,5101000,"Alexandria city, Virginia",61822,1657,31149,2059,30673,2314
1600000US5103000,5103000,"Arlington CDP, Virginia",91529,2121,47307,2338,44222,2379
1600000US5116000,5116000,"Chesapeake city, Virginia",78340,1023,59463,2031,18877,2047
1600000US5135000,5135000,"Hampton city, Virginia",54508,1312,33788,1951,20720,1784
1600000US5147672,5147672,"Lynchburg city, Virginia",25956,1286,15153,1284,10803,1211
1600000US5156000,5156000,"Newport News city, Virginia",74060,1426,38716,1946,35344,2209
1600000US5157000,5157000,"Norfolk city, Virginia",85453,1746,39182,1931,46271,2168
1600000US5164000,5164000,"Portsmouth city, Virginia",39570,1034,24924,1585,14646,1574
1600000US5167000,5167000,"Richmond city, Virginia",81121,1762,41408,2449,39713,2630
1600000US5168000,5168000,"Roanoke city, Virginia",42604,1171,25219,1749,17385,1678
1600000US5176432,5176432,"Suffolk city, Virginia",30009,867,20178,1236,9831,1368
1600000US5182000,5182000,"Virginia Beach city, Virginia",162546,2247,112444,3321,50102,3370
1600000US5305210,5305210,"Bellevue city, Washington",49762,2267,30820,1764,18942,1822
1600000US5305280,5305280,"Bellingham city, Washington",32516,1788,13989,1492,18527,2092
1600000US5322640,5322640,"Everett city, Washington",39928,2348,18525,1738,21403,2370
1600000US5323515,5323515,"Federal Way city, Washington",32278,2153,19144,1625,13134,1827
1600000US5335415,5335415,"Kent city, Washington",35156,2327,17060,1467,18096,2242
1600000US5363000,5363000,"Seattle city, Washington",264953,5250,134869,4265,130084,5192
1600000US5367000,5367000,"Spokane city, Washington",86676,2166,51185,1996,35491,2331
1600000US5367167,5367167,"Spokane Valley city, Washington",36792,1994,22796,1627,13996,1923
1600000US5370000,5370000,"Tacoma city, Washington",77281,2748,42302,2086,34979,2835
1600000US5374060,5374060,"Vancouver city, Washington",61738,2180,33780,1987,27958,2042
1600000US5380010,5380010,"Yakima city, Washington",29227,1961,16189,1527,13038,1718
1600000US5502375,5502375,"Appleton city, Wisconsin",28810,1330,19890,1108,8920,1285
1600000US5531000,5531000,"Green Bay city, Wisconsin",41913,1864,24253,1334,17660,1761
1600000US5539225,5539225,"Kenosha city, Wisconsin",36012,1757,22553,1632,13459,1666
1600000US5548000,5548000,"Madison city, Wisconsin",88656,2888,48703,2189,39953,2342
1600000US5553000,5553000,"Milwaukee city, Wisconsin",219400,4054,105005,3484,114395,3850
1600000US5566000,5566000,"Racine city, Wisconsin",30882,1648,17067,1277,13815,1562
1600000US5584250,5584250,"Waukesha city, Wisconsin",28500,1594,16499,1518,12001,1343
