GEO.id,GEO.id2,GEO.display-label,HD01_VD01,HD02_VD01,HD01_VD02,HD02_VD02,HD01_VD03,HD02_VD03
1600000US0107000,0107000,"Birmingham city, Alabama",90047,3829,48409,3145,41638,3409
1600000US0135896,0135896,"Hoover city, Alabama",30412,1938,20761,1466,9651,1550
1600000US0137000,0137000,"Huntsville city, Alabama",70322,2134,44279,2105,26043,1902
1600000US0150000,0150000,"Mobile city, Alabama",73057,2931,45512,2687,27545,2167
1600000US0151000,0151000,"Montgomery city, Alabama",81704,2665,50406,2417,31298,2176
1600000US0177256,0177256,"Tuscaloosa city, Alabama",33228,1840,16144,1665,17084,1830
1600000US0203000,0203000,"Anchorage municipality, Alaska",102282,1569,62503,2504,39779,2385
1600000US0404720,0404720,"Avondale city, Arizona",17932,1625,12336,1242,5596,1179
1600000US0412000,0412000,"Chandler city, Arizona",82881,3528,56096,2406,26785,2786
1600000US0427400,0427400,"Gilbert town, Arizona",54404,2477,43042,2149,11362,1804
1600000US0427820,0427820,"Glendale city, Arizona",77316,3314,48750,2273,28566,2768
1600000US0446000,0446000,"Mesa city, Arizona",172391,4370,116966,3714,55425,3738
1600000US0454050,0454050,"Peoria city, Arizona",53848,2758,42233,2585,11615,1817
1600000US0455000,0455000,"Phoenix city, Arizona",480510,6819,291051,5628,189459,5681
1600000US0465000,0465000,"Scottsdale city, Arizona",98642,3792,70269,3292,28373,2615
1600000US0471510,0471510,"Surprise city, Arizona",37319,1786,31077,1634,6242,1256
1600000US0473000,0473000,"Tempe city, Arizona",59771,3252,28314,1726,31457,2791
1600000US0477000,0477000,"Tucson city, Arizona",204019,4210,111948,4223,92071,4642
1600000US0485540,0485540,"Yuma city, Arizona",35440,2298,23537,1927,11903,1936
1600000US0523290,0523290,"Fayetteville city, Arkansas",27343,1654,11423,1244,15920,1746
1600000US0524550,0524550,"Fort Smith city, Arkansas",32709,1524,18778,1459,13931,1283
1600000US0541000,0541000,"Little Rock city, Arkansas",80610,2998,47280,2245,33330,3060
1600000US0600562,0600562,"Alameda city, California",29287,1602,14686,1216,14601,1516
1600000US0600884,0600884,"Alhambra city, California",28703,1956,12170,1305,16533,1766
1600000US0602000,0602000,"Anaheim city, California",98736,3465,50896,2455,47840,3046
1600000US0602252,0602252,"Antioch city, California",31335,2179,23440,1510,7895,1637
1600000US0602364,0602364,"Apple Valley town, California",24128,1982,17464,1647,6664,1313
1600000US0602553,0602553,"Arden-Arcade CDP, California",40435,2409,21463,1757,18972,2296
1600000US0603526,0603526,"Bakersfield city, California",100683,2992,60097,2746,40586,3129
1600000US0603666,0603666,"Baldwin Park city, California",18143,1679,11227,1288,6916,1416
1600000US0604982,0604982,"Bellflower city, California",24260,1944,9511,1213,14749,1847
1600000US0606000,0606000,"Berkeley city, California",42149,2223,20059,1386,22090,1839
1600000US0608786,0608786,"Buena Park city, California",23495,1765,12874,1323,10621,1651
1600000US0608954,0608954,"Burbank city, California",42815,2419,19135,1651,23680,2152
1600000US0611194,0611194,"Carlsbad city, California",37136,2149,25683,1674,11453,1849
1600000US0611530,0611530,"Carson city, California",24726,2115,19527,1699,5199,1255
1600000US0613014,0613014,"Chico city, California",28930,1665,11213,1312,17717,1686
1600000US0613210,0613210,"Chino city, California",19749,2070,14576,1872,5173,1342
1600000US0613214,0613214,"Chino Hills city, California",23369,1700,19676,1621,3693,1103
1600000US0613392,0613392,"Chula Vista city, California",67704,2732,41866,2542,25838,2200
1600000US0613588,0613588,"Citrus Heights city, California",33454,2439,19624,1781,13830,2068
1600000US0614218,0614218,"Clovis city, California",29752,2120,16715,1397,13037,1945
1600000US0615044,0615044,"Compton city, California",23018,1535,14912,1277,8106,1302
1600000US0616000,0616000,"Concord city, California",43015,2700,26479,2400,16536,2021
1600000US0616350,0616350,"Corona city, California",47358,2542,31331,2280,16027,1839
1600000US0616532,0616532,"Costa Mesa city, California",38266,2301,16525,1289,21741,2114
1600000US0617918,0617918,"Daly City city, California",29249,1919,18850,1471,10399,1474
1600000US0619766,0619766,"Downey city, California",33622,2416,18249,1685,15373,1902
1600000US0620802,0620802,"East Los Angeles CDP, California",30219,2130,10894,1258,19325,1951
1600000US0621712,0621712,"El Cajon city, California",32289,2060,15318,1334,16971,1976
1600000US0622020,0622020,"Elk Grove city, California",45525,2452,35599,2435,9926,1793
1600000US0622230,0622230,"El Monte city, California",28066,1927,12122,1302,15944,1647
1600000US0622804,0622804,"Escondido city, California",45803,2685,24056,1647,21747,2308
1600000US0623182,0623182,"Fairfield city, California",34730,1922,22721,1662,12009,1385
1600000US0624477,0624477,"Florence-Graham CDP, California",14387,1494,5190,954,9197,1380
1600000US0624638,0624638,"Folsom city, California",23727,1692,17147,1462,6580,1223
1600000US0624680,0624680,"Fontana city, California",44034,2892,31373,2696,12661,1894
1600000US0626000,0626000,"Fremont city, California",67668,3100,44370,2306,23298,2420
1600000US0627000,0627000,"Fresno city, California",153244,3305,76290,3123,76954,3386
1600000US0628000,0628000,"Fullerton city, California",44179,2540,24635,1919,19544,2247
1600000US0629000,0629000,"Garden Grove city, California",43643,3547,26051,2729,17592,2640
1600000US0630000,0630000,"Glendale city, California",69731,3689,27829,2306,41902,3424
1600000US0632548,0632548,"Hawthorne city, California",28363,2014,8775,1500,19588,1843
1600000US0633000,0633000,"Hayward city, California",41428,2105,24702,1819,16726,1621
1600000US0633182,0633182,"Hemet city, California",26277,1794,15618,1421,10659,1413
1600000US0633434,0633434,"Hesperia city, California",25662,1900,19992,1795,5670,1253
1600000US0636000,0636000,"Huntington Beach city, California",73006,2660,45550,2158,27456,2560
1600000US0636448,0636448,"Indio city, California",20808,1995,13207,1496,7601,1363
1600000US0636546,0636546,"Inglewood city, California",37562,2577,14655,1644,22907,2118
1600000US0636770,0636770,"Irvine city, California",63646,2875,35907,2372,27739,2141
1600000US0639496,0639496,"Lake Forest city, California",26416,1830,19654,1586,6762,1337
1600000US0639892,0639892,"Lakewood city, California",26548,1756,20611,1504,5937,1303
1600000US0640130,0640130,"Lancaster city, California",40695,2189,25830,1941,14865,1815
1600000US0641992,0641992,"Livermore city, California",27287,1775,19227,1599,8060,1618
1600000US0643000,0643000,"Long Beach city, California",161926,4380,70314,3166,91612,3961
1600000US0644000,0644000,"Los Angeles city, California",1273880,10436,509223,8234,764657,10598
1600000US0644574,0644574,"Lynwood city, California",15349,1574,7707,1075,7642,1293
1600000US0646898,0646898,"Merced city, California",23072,2014,9200,1381,13872,2110
1600000US0648256,0648256,"Mission Viejo city, California",33190,1826,26287,1422,6903,1274
1600000US0648354,0648354,"Modesto city, California",67772,2458,42388,2515,25384,2251
1600000US0649270,0649270,"Moreno Valley city, California",47501,2695,33649,2337,13852,1967
1600000US0649670,0649670,"Mountain View city, California",31466,2006,13230,1247,18236,2216
1600000US0650076,0650076,"Murrieta city, California",29076,2075,24084,1950,4992,1301
1600000US0650258,0650258,"Napa city, California",28154,1450,15755,1497,12399,1579
1600000US0651182,0651182,"Newport Beach city, California",38389,2163,22909,1704,15480,1719
1600000US0652526,0652526,"Norwalk city, California",27777,2029,18279,1585,9498,1814
1600000US0653000,0653000,"Oakland city, California",144747,3564,63321,3298,81426,3764
1600000US0653322,0653322,"Oceanside city, California",59874,3196,38700,2495,21174,2202
1600000US0653896,0653896,"Ontario city, California",44267,2806,26800,2185,17467,2138
1600000US0653980,0653980,"Orange city, California",40720,2347,25572,1772,15148,2096
1600000US0654652,0654652,"Oxnard city, California",46443,2587,27499,2186,18944,1987
1600000US0655156,0655156,"Palmdale city, California",39168,2591,28229,2135,10939,1689
1600000US0656000,0656000,"Pasadena city, California",54247,2552,25068,1733,29179,2567
1600000US0657792,0657792,"Pleasanton city, California",25562,1448,17865,1274,7697,1271
1600000US0658072,0658072,"Pomona city, California",37014,2280,22391,2001,14623,1876
1600000US0659451,0659451,"Rancho Cucamonga city, California",49796,2463,34505,2294,15291,1735
1600000US0659920,0659920,"Redding city, California",34519,1781,20130,1468,14389,1726
1600000US0659962,0659962,"Redlands city, California",25909,2090,16661,1539,9248,1600
1600000US0660018,0660018,"Redondo Beach city, California",29171,2054,14431,1265,14740,1873
1600000US0660102,0660102,"Redwood City city, California",27582,1878,14197,1246,13385,1436
1600000US0660466,0660466,"Rialto city, California",25178,2255,17786,1883,7392,1360
1600000US0660620,0660620,"Richmond city, California",35036,2566,19944,1772,15092,2013
1600000US0662000,0662000,"Riverside city, California",96151,3472,54262,3074,41889,2935
1600000US0662938,0662938,"Roseville city, California",43155,2287,29311,2181,13844,2009
1600000US0664000,0664000,"Sacramento city, California",169225,4576,88054,3979,81171,4130
1600000US0664224,0664224,"Salinas city, California",39205,1945,19373,1841,19832,2034
1600000US0665000,0665000,"San Bernardino city, California",61616,3139,31774,2308,29842,2616
1600000US0665042,0665042,"San Buenaventura (Ventura) city, California",39723,1900,23172,1466,16551,1684
1600000US0666000,0666000,"San Diego city, California",463321,6965,233813,5744,229508,5940
1600000US0667000,0667000,"San Francisco city, California",322547,3195,126712,4349,195835,4469
1600000US0668000,0668000,"San Jose city, California",290828,4856,179518,4493,111310,4931
1600000US0668084,0668084,"San Leandro city, California",32343,2174,19761,1558,12582,1780
1600000US0668196,0668196,"San Marcos city, California",24861,2076,16386,1527,8475,1538
1600000US0668252,0668252,"San Mateo city, California",36795,1854,20080,1546,16715,1765
1600000US0669000,0669000,"Santa Ana city, California",77747,3077,39775,2416,37972,2933
1600000US0669070,0669070,"Santa Barbara city, California",33353,1920,14033,1366,19320,1977
1600000US0669084,0669084,"Santa Clara city, California",42378,2487,19535,1541,22843,2362
1600000US0669088,0669088,"Santa Clarita city, California",51028,2621,37905,2099,13123,2050
1600000US0669196,0669196,"Santa Maria city, California",26617,1896,13122,1238,13495,1619
1600000US0670000,0670000,"Santa Monica city, California",46725,2557,14148,1642,32577,2555
1600000US0670098,0670098,"Santa Rosa city, California",59082,2439,33993,2034,25089,2509
1600000US0672016,0672016,"Simi Valley city, California",39899,2013,31597,1753,8302,1458
1600000US0673080,0673080,"South Gate city, California",24441,1435,10905,1325,13536,1429
1600000US0675000,0675000,"Stockton city, California",90236,2916,50129,2238,40107,2852
1600000US0677000,0677000,"Sunnyvale city, California",52798,2354,26487,1603,26311,2036
1600000US0678120,0678120,"Temecula city, California",25935,2366,17822,1800,8113,1693
1600000US0678582,0678582,"Thousand Oaks city, California",43939,1992,33335,1576,10604,1460
1600000US0680000,0680000,"Torrance city, California",53925,2427,30598,1620,23327,2121
1600000US0680238,0680238,"Tracy city, California",25281,2108,19039,2032,6242,1154
1600000US0680812,0680812,"Turlock city, California",22127,1735,12137,1418,9990,1320
1600000US0680854,0680854,"Tustin city, California",21988,1852,12134,1387,9854,1652
1600000US0681204,0681204,"Union City city, California",18247,1758,13750,1409,4497,1092
1600000US0681344,0681344,"Upland city, California",25840,2226,14735,1555,11105,2026
1600000US0681554,0681554,"Vacaville city, California",29253,2176,18953,1590,10300,1443
1600000US0681666,0681666,"Vallejo city, California",39567,1785,25022,1821,14545,1453
1600000US0682590,0682590,"Victorville city, California",28589,2275,19275,1898,9314,1628
1600000US0682954,0682954,"Visalia city, California",37255,2075,23214,1741,14041,1647
1600000US0682996,0682996,"Vista city, California",28972,2271,16721,1588,12251,1856
1600000US0684200,0684200,"West Covina city, California",32019,2143,21464,1706,10555,1557
1600000US0684550,0684550,"Westminster city, California",26630,1854,15438,1564,11192,1442
1600000US0685292,0685292,"Whittier city, California",30457,2042,17107,1466,13350,1819
1600000US0686832,0686832,"Yorba Linda city, California",20734,1955,17931,1969,2803,891
1600000US0803455,0803455,"Arvada city, Colorado",40516,2119,32144,1671,8372,1588
1600000US0804000,0804000,"Aurora city, Colorado",115209,3210,72970,2941,42239,2715
1600000US0807850,0807850,"Boulder city, Colorado",37873,2008,18482,1392,19391,1586
1600000US0812815,0812815,"Centennial city, Colorado",37702,1851,32790,1640,4912,955
1600000US0816000,0816000,"Colorado Springs city, Colorado",159324,3332,102637,3220,56687,3690
1600000US0820000,0820000,"Denver city, Colorado",246047,3124,136802,3865,109245,4532
1600000US0827425,0827425,"Fort Collins city, Colorado",55784,2210,30295,1917,25489,2334
1600000US0832155,0832155,"Greeley city, Colorado",31736,1788,18921,1351,12815,1593
1600000US0836410,0836410,"Highlands Ranch CDP, Colorado",31814,1627,27651,1558,4163,969
1600000US0843000,0843000,"Lakewood city, Colorado",60762,2476,37442,1817,23320,1995
1600000US0845970,0845970,"Longmont city, Colorado",31545,1572,20833,1392,10712,1418
1600000US0862000,0862000,"Pueblo city, Colorado",41729,1608,26232,1550,15497,1715
1600000US0877290,0877290,"Thornton city, Colorado",37963,2251,26596,1905,11367,1564
1600000US0883835,0883835,"Westminster city, Colorado",39539,1880,29299,1597,10240,1386
1600000US0908000,0908000,"Bridgeport city, Connecticut",51067,2956,22727,1821,28340,2394
1600000US0918430,0918430,"Danbury city, Connecticut",28549,2193,18577,1568,9972,1771
1600000US0937000,0937000,"Hartford city, Connecticut",44296,2668,11256,1592,33040,2592
1600000US0950370,0950370,"New Britain city, Connecticut",27371,2056,12747,1259,14624,1648
1600000US0952000,0952000,"New Haven city, Connecticut",46011,2457,15148,1549,30863,2387
1600000US0955990,0955990,"Norwalk city, Connecticut",31695,1723,19811,1430,11884,1569
1600000US0973000,0973000,"Stamford city, Connecticut",46324,2259,27916,1889,18408,2267
1600000US0980000,0980000,"Waterbury city, Connecticut",42270,2377,21332,1821,20938,2228
1600000US1077580,1077580,"Wilmington city, Delaware",26443,2007,13271,1343,13172,1897
1600000US1150000,1150000,"Washington city, District of Columbia",250456,3518,114586,3453,135870,4564
1600000US1207300,1207300,"Boca Raton city, Florida",32121,2473,23878,1837,8243,1552
1600000US1207875,1207875,"Boynton Beach city, Florida",26379,1971,18445,1591,7934,1436
1600000US1208150,1208150,"Brandon CDP, Florida",35471,2199,23496,1676,11975,1655
1600000US1210275,1210275,"Cape Coral city, Florida",58746,3367,45784,2532,12962,2306
1600000US1212875,1212875,"Clearwater city, Florida",50944,2396,31608,2032,19336,1867
1600000US1214400,1214400,"Coral Springs city, Florida",44315,2416,30489,2099,13826,1732
1600000US1216475,1216475,"Davie town, Florida",29170,2104,23009,1864,6161,1095
1600000US1216725,1216725,"Deerfield Beach city, Florida",34474,2597,23369,2003,11105,1802
1600000US1217200,1217200,"Deltona city, Florida",29592,2183,25276,2121,4316,1250
1600000US1224000,1224000,"Fort Lauderdale city, Florida",74440,2881,44510,2532,29930,2588
1600000US1225175,1225175,"Gainesville city, Florida",45730,2279,20557,1665,25173,2333
1600000US1230000,1230000,"Hialeah city, Florida",69700,3295,36417,2950,33283,2737
1600000US1232000,1232000,"Hollywood city, Florida",59862,2845,37089,2317,22773,2422
1600000US1235000,1235000,"Jacksonville city, Florida",315796,4341,198838,4276,116958,4900
1600000US1236100,1236100,"Kendall CDP, Florida",26910,1741,19112,1672,7798,1333
1600000US1238250,1238250,"Lakeland city, Florida",42979,2386,22778,1580,20201,2100
1600000US1239425,1239425,"Largo city, Florida",36226,2437,23497,1699,12729,2197
1600000US1239925,1239925,"Lehigh Acres CDP, Florida",23981,2027,17857,1794,6124,1560
1600000US1243975,1243975,"Melbourne city, Florida",33378,1976,21278,1570,12100,1791
1600000US1245000,1245000,"Miami city, Florida",135153,4645,48855,3291,86298,4546
1600000US1245025,1245025,"Miami Beach city, Florida",44521,2864,19109,1857,25412,2223
1600000US1245060,1245060,"Miami Gardens city, Florida",30817,2262,21366,2048,9451,1484
1600000US1245975,1245975,"Miramar city, Florida",34273,1983,25906,1711,8367,1481
1600000US1253000,1253000,"Orlando city, Florida",92491,3481,38093,2354,54398,3284
1600000US1254000,1254000,"Palm Bay city, Florida",35593,2389,29225,2223,6368,1437
1600000US1254200,1254200,"Palm Coast city, Florida",26478,1993,21455,1801,5023,1662
1600000US1255775,1255775,"Pembroke Pines city, Florida",55803,2970,45420,2792,10383,1940
1600000US1257425,1257425,"Plantation city, Florida",31938,1917,23873,1728,8065,1409
1600000US1258050,1258050,"Pompano Beach city, Florida",41584,2559,26596,2211,14988,2172
1600000US1258715,1258715,"Port St. Lucie city, Florida",53092,2014,43919,2011,9173,1718
1600000US1263000,1263000,"St. Petersburg city, Florida",110291,3956,74434,3190,35857,2625
1600000US1268350,1268350,"Spring Hill CDP, Florida",36146,1689,30463,1710,5683,1218
1600000US1269700,1269700,"Sunrise city, Florida",31992,1937,24156,1886,7836,1341
1600000US1270600,1270600,"Tallahassee city, Florida",70178,2353,30744,1766,39434,2214
1600000US1271000,1271000,"Tampa city, Florida",132894,4367,76039,3678,56855,4166
1600000US1272145,1272145,"Town 'n' Country CDP, Florida",29932,2218,20487,1788,9445,1669
1600000US1276582,1276582,"Weston city, Florida",21646,1591,17041,1297,4605,1256
1600000US1276600,1276600,"West Palm Beach city, Florida",36754,2350,20212,1795,16542,2158
1600000US1301052,1301052,"Albany city, Georgia",30251,1427,12783,1356,17468,1467
1600000US1303440,1303440,"Athens-Clarke County (balance), Georgia",41922,1538,18723,1392,23199,1719
1600000US1304000,1304000,"Atlanta city, Georgia",169248,5374,83918,3359,85330,4293
1600000US1304204,1304204,"Augusta-Richmond County (balance), Georgia",74508,1812,43242,2120,31266,2160
1600000US1319000,1319000,"Columbus city, Georgia",71660,2075,42205,2249,29455,2654
1600000US1349000,1349000,"Macon city, Georgia",36304,1829,17871,1415,18433,1907
1600000US1367284,1367284,"Roswell city, Georgia",31966,1944,25079,1695,6887,1287
1600000US1368516,1368516,"Sandy Springs city, Georgia",43109,2353,24935,1827,18174,1962
1600000US1369000,1369000,"Savannah city, Georgia",53034,2155,25467,1599,27567,2242
1600000US1517000,1517000,"Honolulu CDP, Hawaii",139086,3944,70599,3009,68487,3663
1600000US1608830,1608830,"Boise City city, Idaho",86706,2276,54101,2222,32605,1935
1600000US1656260,1656260,"Nampa city, Idaho",24262,1654,16255,1474,8007,1333
1600000US1702154,1702154,"Arlington Heights village, Illinois",30013,1818,23845,1566,6168,1210
1600000US1703012,1703012,"Aurora city, Illinois",58303,3123,42615,2882,15688,1885
1600000US1706613,1706613,"Bloomington city, Illinois",28699,1628,18609,1609,10090,1310
1600000US1707133,1707133,"Bolingbrook village, Illinois",22838,1802,19593,1464,3245,1249
1600000US1712385,1712385,"Champaign city, Illinois",28110,1753,14119,1134,13991,1636
1600000US1714000,1714000,"Chicago city, Illinois",1015685,9647,500638,8731,515047,9446
1600000US1714351,1714351,"Cicero town, Illinois",21992,1937,11880,1404,10112,1655
1600000US1718823,1718823,"Decatur city, Illinois",33991,1613,21812,1549,12179,1279
1600000US1723074,1723074,"Elgin city, Illinois",31970,1978,21801,1521,10169,1601
1600000US1724582,1724582,"Evanston city, Illinois",27898,1840,16421,1486,11477,1566
1600000US1738570,1738570,"Joliet city, Illinois",45523,2656,34872,2207,10651,1678
1600000US1751622,1751622,"Naperville city, Illinois",47424,2080,37557,1674,9867,1727
1600000US1757225,1757225,"Palatine village, Illinois",25416,1688,18857,1458,6559,1266
1600000US1759000,1759000,"Peoria city, Illinois",46357,1679,28719,1608,17638,1755
1600000US1765000,1765000,"Rockford city, Illinois",57039,2117,34868,1819,22171,1934
1600000US1768003,1768003,"Schaumburg village, Illinois",32131,1794,22634,1387,9497,1474
1600000US1770122,1770122,"Skokie village, Illinois",23759,1549,17838,1144,5921,1277
1600000US1772000,1772000,"Springfield city, Illinois",47884,2053,30530,1734,17354,1454
1600000US1779293,1779293,"Waukegan city, Illinois",26544,1865,15890,1426,10654,1668
1600000US1805860,1805860,"Bloomington city, Indiana",24093,1768,9915,1095,14178,1498
1600000US1822000,1822000,"Evansville city, Indiana",51688,1772,31819,1877,19869,2054
1600000US1825000,1825000,"Fort Wayne city, Indiana",101024,2566,64023,2480,37001,2188
1600000US1827000,1827000,"Gary city, Indiana",33180,2194,18167,1691,15013,1751
1600000US1831000,1831000,"Hammond city, Indiana",28422,2027,18701,1377,9721,1794
1600000US1836003,1836003,"Indianapolis city (balance), Indiana",321357,4514,190752,3670,130605,4679
1600000US1851876,1851876,"Muncie city, Indiana",25118,1943,14063,1306,11055,1603
1600000US1871000,1871000,"South Bend city, Indiana",39244,1797,25220,1429,14024,1533
1600000US1912000,1912000,"Cedar Rapids city, Iowa",53937,1830,37214,1730,16723,1774
1600000US1919000,1919000,"Davenport city, Iowa",40679,1545,26172,1662,14507,1473
1600000US1921000,1921000,"Des Moines city, Iowa",84433,2298,58097,2252,26336,2338
1600000US1973335,1973335,"Sioux City city, Iowa",31625,1142,21557,1306,10068,1437
1600000US1982425,1982425,"Waterloo city, Iowa",28420,1199,19755,1175,8665,1170
1600000US2036000,2036000,"Kansas City city, Kansas",53882,1736,34500,1728,19382,1929
1600000US2038900,2038900,"Lawrence city, Kansas",33743,1254,17577,1151,16166,1352
1600000US2052575,2052575,"Olathe city, Kansas",40601,1891,29562,1468,11039,1412
1600000US2053775,2053775,"Overland Park city, Kansas",66195,2172,44731,1709,21464,2137
1600000US2071000,2071000,"Topeka city, Kansas",51189,1953,31366,1781,19823,1593
1600000US2079000,2079000,"Wichita city, Kansas",147480,2653,93960,2547,53520,3009
1600000US2146027,2146027,"Lexington-Fayette, Kentucky",117528,2042,68702,2196,48826,2519
1600000US2148006,2148006,"Louisville/Jefferson County (balance), Kentucky",232042,3637,150813,3623,81229,3752
1600000US2205000,2205000,"Baton Rouge city, Louisiana",88725,3334,46805,2691,41920,2918
1600000US2239475,2239475,"Kenner city, Louisiana",22778,1806,13175,1204,9603,1693
1600000US2240735,2240735,"Lafayette city, Louisiana",47888,1786,29309,1850,18579,1554
1600000US2241155,2241155,"Lake Charles city, Louisiana",28561,1672,17093,1437,11468,1351
1600000US2250115,2250115,"Metairie CDP, Louisiana",50515,1982,34598,1724,15917,1825
1600000US2255000,2255000,"New Orleans city, Louisiana",73516,1838,37273,2150,36243,2361
1600000US2270000,2270000,"Shreveport city, Louisiana",76529,2493,45866,2254,30663,2206
1600000US2404000,2404000,"Baltimore city, Maryland",237758,3586,120431,4328,117327,4196
1600000US2419125,2419125,"Columbia CDP, Maryland",34796,1414,23256,1237,11540,1188
1600000US2472450,2472450,"Silver Spring CDP, Maryland",29720,1933,14319,1167,15401,1533
1600000US2507000,2507000,"Boston city, Massachusetts",231522,3868,89280,4261,142242,4095
1600000US2509000,2509000,"Brockton city, Massachusetts",34160,1865,19499,1507,14661,2017
1600000US2511000,2511000,"Cambridge city, Massachusetts",40976,2191,15969,1536,25007,2094
1600000US2523000,2523000,"Fall River city, Massachusetts",38094,2602,14156,1587,23938,2203
1600000US2524960,2524960,"Framingham CDP, Massachusetts",25708,1515,14729,1132,10979,1409
1600000US2534550,2534550,"Lawrence city, Massachusetts",24879,1638,8942,1354,15937,1493
1600000US2537000,2537000,"Lowell city, Massachusetts",34895,2087,18306,1543,16589,1742
1600000US2537490,2537490,"Lynn city, Massachusetts",32433,2286,16008,1503,16425,1883
1600000US2545000,2545000,"New Bedford city, Massachusetts",38388,1779,16076,1321,22312,1860
1600000US2545560,2545560,"Newton city, Massachusetts",30721,1629,21694,1247,9027,1404
1600000US2555745,2555745,"Quincy city, Massachusetts",40389,2429,19934,1787,20455,2426
1600000US2562535,2562535,"Somerville city, Massachusetts",28958,2435,10110,1427,18848,2428
1600000US2567000,2567000,"Springfield city, Massachusetts",55338,2482,28536,1873,26802,2375
1600000US2582000,2582000,"Worcester city, Massachusetts",66808,2752,31823,2412,34985,2852
1600000US2603000,2603000,"Ann Arbor city, Michigan",45628,2351,20146,1248,25482,2170
1600000US2613110,2613110,"Canton CDP, Michigan",32396,1618,25900,1482,6496,1178
1600000US2616510,2616510,"Clinton CDP, Michigan",40839,1955,30824,1560,10015,1508
1600000US2621000,2621000,"Dearborn city, Michigan",34432,1864,25759,1574,8673,1423
1600000US2622000,2622000,"Detroit city, Michigan",288477,4869,160154,5156,128323,4405
1600000US2627440,2627440,"Farmington Hills city, Michigan",34389,1890,22724,1415,11665,1485
1600000US2629000,2629000,"Flint city, Michigan",45676,1962,26164,1679,19512,1725
1600000US2634000,2634000,"Grand Rapids city, Michigan",72626,2283,44249,2031,28377,2343
1600000US2642160,2642160,"Kalamazoo city, Michigan",26782,1672,13074,1206,13708,1779
1600000US2646000,2646000,"Lansing city, Michigan",48302,2101,27912,1871,20390,1694
1600000US2649000,2649000,"Livonia city, Michigan",37947,1424,34206,1297,3741,882
1600000US2665440,2665440,"Pontiac city, Michigan",24865,1781,13272,1274,11593,1592
1600000US2669035,2669035,"Rochester Hills city, Michigan",27968,1432,21682,1349,6286,1169
1600000US2672818,2672818,"Shelby CDP, Michigan",27831,1625,22348,1284,5483,1218
1600000US2674900,2674900,"Southfield city, Michigan",31267,1712,18125,1439,13142,1520
1600000US2676460,2676460,"Sterling Heights city, Michigan",47833,2096,39078,1695,8755,1324
1600000US2680700,2680700,"Troy city, Michigan",30638,1477,23674,973,6964,1125
1600000US2684000,2684000,"Warren city, Michigan",54092,2145,43904,2012,10188,1466
1600000US2684220,2684220,"Waterford CDP, Michigan",29145,1448,23088,1449,6057,1120
1600000US2685510,2685510,"West Bloomfield Township CDP, Michigan",24788,1142,21276,1046,3512,760
1600000US2686000,2686000,"Westland city, Michigan",36482,1765,23121,1424,13361,1603
1600000US2688940,2688940,"Wyoming city, Michigan",27429,1750,17994,1402,9435,1458
1600000US2706616,2706616,"Bloomington city, Minnesota",36375,1640,25613,1334,10762,1225
1600000US2707966,2707966,"Brooklyn Park city, Minnesota",26364,1594,19753,1437,6611,1269
1600000US2717000,2717000,"Duluth city, Minnesota",34435,1559,23015,1256,11420,1187
1600000US2743000,2743000,"Minneapolis city, Minnesota",155646,3399,84156,2671,71490,3198
1600000US2751730,2751730,"Plymouth city, Minnesota",27094,1253,20965,1161,6129,996
1600000US2754880,2754880,"Rochester city, Minnesota",39177,1229,28558,1310,10619,1243
1600000US2756896,2756896,"St. Cloud city, Minnesota",24375,1635,13540,1160,10835,1282
1600000US2758000,2758000,"St. Paul city, Minnesota",108084,2668,63756,2556,44328,2302
1600000US2829700,2829700,"Gulfport city, Mississippi",24603,1790,16539,1530,8064,1521
1600000US2836000,2836000,"Jackson city, Mississippi",63247,2271,36164,2082,27083,2256
1600000US2915670,2915670,"Columbia city, Missouri",40077,1528,19650,1447,20427,1981
1600000US2935000,2935000,"Independence city, Missouri",50247,2445,34925,2130,15322,1938
1600000US2938000,2938000,"Kansas City city, Missouri",183314,4367,108804,2978,74510,3887
1600000US2941348,2941348,"Lee's Summit city, Missouri",33512,1995,25474,1590,8038,1374
1600000US2954074,2954074,"O'Fallon city, Missouri",24450,1771,21154,1608,3296,932
1600000US2964550,2964550,"St. Joseph city, Missouri",28098,1165,18694,1368,9404,1405
1600000US2965000,2965000,"St. Louis city, Missouri",139929,2746,70560,3103,69369,3356
1600000US2970000,2970000,"Springfield city, Missouri",68932,2188,37057,2010,31875,2050
1600000US3006550,3006550,"Billings city, Montana",40408,1269,27673,1618,12735,1415
1600000US3128000,3128000,"Lincoln city, Nebraska",96849,1824,57328,1939,39521,2295
1600000US3137000,3137000,"Omaha city, Nebraska",154801,2335,91349,2687,63452,2873
1600000US3223770,3223770,"Enterprise CDP, Nevada",29476,2327,19553,1826,9923,1763
1600000US3231900,3231900,"Henderson city, Nevada",92774,3170,62969,2711,29805,2596
1600000US3240000,3240000,"Las Vegas city, Nevada",208872,4784,129043,3969,79829,3693
1600000US3251800,3251800,"North Las Vegas city, Nevada",58081,2823,39603,2615,18478,1983
1600000US3254600,3254600,"Paradise CDP, Nevada",82495,3081,37672,2034,44823,2744
1600000US3260600,3260600,"Reno city, Nevada",86000,2890,41989,2280,44011,2850
1600000US3268400,3268400,"Sparks city, Nevada",31489,2000,20646,1528,10843,1482
1600000US3268585,3268585,"Spring Valley CDP, Nevada",64462,2623,35922,2553,28540,2638
1600000US3271400,3271400,"Sunrise Manor CDP, Nevada",62401,2845,37589,2112,24812,2170
1600000US3345140,3345140,"Manchester city, New Hampshire",43449,1976,22633,1622,20816,2064
1600000US3350260,3350260,"Nashua city, New Hampshire",35381,1863,21711,1456,13670,1875
1600000US3410000,3410000,"Camden city, New Jersey",24271,1596,10814,1184,13457,1586
1600000US3413690,3413690,"Clifton city, New Jersey",28235,2005,17316,1582,10919,1568
1600000US3419390,3419390,"East Orange city, New Jersey",24809,1884,6559,1072,18250,1738
1600000US3420260,3420260,"Edison CDP, New Jersey",35120,1905,22118,1453,13002,1622
1600000US3421000,3421000,"Elizabeth city, New Jersey",42693,2173,12830,1877,29863,2081
1600000US3436000,3436000,"Jersey City city, New Jersey",90020,3630,29533,1901,60487,3785
1600000US3451000,3451000,"Newark city, New Jersey",92270,3338,22713,1877,69557,3126
1600000US3456550,3456550,"Passaic city, New Jersey",18113,1914,4344,1033,13769,1731
1600000US3457000,3457000,"Paterson city, New Jersey",45802,2566,13770,1512,32032,2537
1600000US3473110,3473110,"Toms River CDP, New Jersey",34266,1664,29116,1532,5150,1080
1600000US3474000,3474000,"Trenton city, New Jersey",27288,2057,12157,1604,15131,1757
1600000US3474630,3474630,"Union City city, New Jersey",21683,1540,4569,767,17114,1458
1600000US3502000,3502000,"Albuquerque city, New Mexico",207017,3252,126854,3546,80163,3641
1600000US3539380,3539380,"Las Cruces city, New Mexico",34214,1869,19968,1515,14246,1710
1600000US3563460,3563460,"Rio Rancho city, New Mexico",24690,995,19546,1085,5144,937
1600000US3570500,3570500,"Santa Fe city, New Mexico",26611,1498,16398,1123,10213,1346
1600000US3601000,3601000,"Albany city, New York",37366,1994,15211,1287,22155,1707
1600000US3611000,3611000,"Buffalo city, New York",110726,3310,48903,2597,61823,3204
1600000US3615000,3615000,"Cheektowaga CDP, New York",32570,1458,22709,1353,9861,1199
1600000US3649121,3649121,"Mount Vernon city, New York",24834,2044,10069,1471,14765,1685
1600000US3650617,3650617,"New Rochelle city, New York",24275,1724,13067,1050,11208,1618
1600000US3651000,3651000,"New York city, New York",3020284,9874,1040037,11742,1980247,12980
1600000US3663000,3663000,"Rochester city, New York",82672,2698,36087,2286,46585,2526
1600000US3673000,3673000,"Syracuse city, New York",54745,2569,21991,1772,32754,2319
1600000US3684000,3684000,"Yonkers city, New York",73329,2510,36674,2099,36655,2189
1600000US3702140,3702140,"Asheville city, North Carolina",35872,1788,20324,1696,15548,1767
1600000US3710740,3710740,"Cary town, North Carolina",41462,2149,29148,1764,12314,1733
1600000US3712000,3712000,"Charlotte city, North Carolina",265768,3728,160555,4041,105213,4139
1600000US3719000,3719000,"Durham city, North Carolina",83369,2275,41490,2431,41879,2532
1600000US3722920,3722920,"Fayetteville city, North Carolina",71706,3004,41355,2237,30351,3003
1600000US3725580,3725580,"Gastonia city, North Carolina",26011,1691,15755,1472,10256,1610
1600000US3728000,3728000,"Greensboro city, North Carolina",96746,2828,51707,2591,45039,2595
1600000US3728080,3728080,"Greenville city, North Carolina",32433,2020,11874,1336,20559,2013
1600000US3731400,3731400,"High Point city, North Carolina",37733,2480,22212,1846,15521,2016
1600000US3734200,3734200,"Jacksonville city, North Carolina",18143,1600,8145,947,9998,1385
1600000US3755000,3755000,"Raleigh city, North Carolina",134626,3640,72004,3043,62622,2890
1600000US3774440,3774440,"Wilmington city, North Carolina",44436,2346,22280,1542,22156,2490
1600000US3775000,3775000,"Winston-Salem city, North Carolina",79745,3075,43350,2398,36395,2579
1600000US3825700,3825700,"Fargo city, North Dakota",43779,1452,19785,1306,23994,1606
1600000US3901000,3901000,"Akron city, Ohio",85407,3048,48348,2341,37059,3148
1600000US3912000,3912000,"Canton city, Ohio",32168,2198,18477,1663,13691,2012
1600000US3915000,3915000,"Cincinnati city, Ohio",131059,3265,55442,2630,75617,3516
1600000US3916000,3916000,"Cleveland city, Ohio",168395,4414,83402,3461,84993,3862
1600000US3918000,3918000,"Columbus city, Ohio",306930,4765,155004,4190,151926,4402
1600000US3921000,3921000,"Dayton city, Ohio",61063,2864,32638,1973,28425,2323
1600000US3944856,3944856,"Lorain city, Ohio",25387,1537,15530,1377,9857,1405
1600000US3961000,3961000,"Parma city, Ohio",34243,1768,27764,1463,6479,1046
1600000US3977000,3977000,"Toledo city, Ohio",120946,3171,69658,2205,51288,2928
1600000US3988000,3988000,"Youngstown city, Ohio",28432,1563,17114,1230,11318,1574
1600000US4009050,4009050,"Broken Arrow city, Oklahoma",32424,1571,26794,1444,5630,1110
1600000US4023200,4023200,"Edmond city, Oklahoma",28957,1511,21858,1369,7099,896
1600000US4041850,4041850,"Lawton city, Oklahoma",33607,1181,18644,1484,14963,1686
1600000US4052500,4052500,"Norman city, Oklahoma",40283,1751,21813,1409,18470,1543
1600000US4055000,4055000,"Oklahoma City city, Oklahoma",217479,3746,134876,3677,82603,3764
1600000US4075000,4075000,"Tulsa city, Oklahoma",165236,3165,90075,2689,75161,3003
1600000US4105350,4105350,"Beaverton city, Oregon",31552,1861,18175,1404,13377,1504
1600000US4105800,4105800,"Bend city, Oregon",30024,1937,18824,1793,11200,1694
1600000US4123850,4123850,"Eugene city, Oregon",61958,2532,31200,1827,30758,2506
1600000US4131250,4131250,"Gresham city, Oregon",35686,1923,20769,1684,14917,1529
1600000US4134100,4134100,"Hillsboro city, Oregon",30720,2198,17126,1681,13594,1912
1600000US4147000,4147000,"Medford city, Oregon",29446,1815,16151,1303,13295,1448
1600000US4159000,4159000,"Portland city, Oregon",234931,3434,134101,3901,100830,4257
1600000US4164900,4164900,"Salem city, Oregon",53609,2176,31701,1965,21908,2319
1600000US4202000,4202000,"Allentown city, Pennsylvania",42237,2095,21730,1710,20507,1788
1600000US4206088,4206088,"Bethlehem city, Pennsylvania",28394,1520,17265,1368,11129,1404
1600000US4224000,4224000,"Erie city, Pennsylvania",40821,1492,22794,1518,18027,1512
1600000US4260000,4260000,"Philadelphia city, Pennsylvania",554048,5322,322725,6925,231323,7437
1600000US4261000,4261000,"Pittsburgh city, Pennsylvania",132437,3116,69957,3107,62480,2773
1600000US4263624,4263624,"Reading city, Pennsylvania",28849,1499,12823,1184,16026,1540
1600000US4269000,4269000,"Scranton city, Pennsylvania",29997,1660,15883,1340,14114,1652
1600000US4419180,4419180,"Cranston city, Rhode Island",28263,1637,19743,1686,8520,1422
1600000US4454640,4454640,"Pawtucket city, Rhode Island",28900,1825,13631,1395,15269,1562
1600000US4459000,4459000,"Providence city, Rhode Island",58972,2490,21656,1738,37316,2131
1600000US4474300,4474300,"Warwick city, Rhode Island",35241,1405,26038,1551,9203,1352
1600000US4513330,4513330,"Charleston city, South Carolina",45131,2267,24751,1734,20380,1647
1600000US4516000,4516000,"Columbia city, South Carolina",41635,2460,20111,1614,21524,2132
1600000US4550875,4550875,"North Charleston city, South Carolina",33699,2395,15780,1671,17919,1849
1600000US4659020,4659020,"Sioux Falls city, South Dakota",57237,1552,36179,1530,21058,1841
1600000US4714000,4714000,"Chattanooga city, Tennessee",66518,2605,37723,2242,28795,2337
1600000US4715160,4715160,"Clarksville city, Tennessee",43456,1828,24034,1807,19422,2075
1600000US4740000,4740000,"Knoxville city, Tennessee",79418,3115,40276,2278,39142,2819
1600000US4748000,4748000,"Memphis city, Tennessee",248836,5436,136669,4519,112167,5067
1600000US4751560,4751560,"Murfreesboro city, Tennessee",35842,1661,18104,1697,17738,1860
1600000US4752006,4752006,"Nashville-Davidson (balance), Tennessee",238691,3156,142436,3019,96255,3556
1600000US4801000,4801000,"Abilene city, Texas",42001,1641,25424,1468,16577,1776
1600000US4801924,4801924,"Allen city, Texas",22032,1266,17523,1145,4509,1026
1600000US4803000,4803000,"Amarillo city, Texas",68891,1994,42537,1765,26354,1935
1600000US4804000,4804000,"Arlington city, Texas",128386,3921,74598,2948,53788,3378
1600000US4805000,4805000,"Austin city, Texas",293856,4894,138851,4447,155005,4422
1600000US4806128,4806128,"Baytown city, Texas",25147,2056,14298,1634,10849,1697
1600000US4807000,4807000,"Beaumont city, Texas",44672,2037,26304,1739,18368,1862
1600000US4810768,4810768,"Brownsville city, Texas",49936,2710,30574,1921,19362,2370
1600000US4810912,4810912,"Bryan city, Texas",25230,1768,13991,1520,11239,1782
1600000US4813024,4813024,"Carrollton city, Texas",41060,2243,28286,1544,12774,1573
1600000US4815976,4815976,"College Station city, Texas",27855,1899,9240,1265,18615,1772
1600000US4817000,4817000,"Corpus Christi city, Texas",104094,2551,61439,2572,42655,2651
1600000US4819000,4819000,"Dallas city, Texas",441632,5757,206188,4667,235444,6250
1600000US4819972,4819972,"Denton city, Texas",31513,2132,16117,1679,15396,1709
1600000US4822660,4822660,"Edinburg city, Texas",20851,2171,11385,1404,9466,1870
1600000US4824000,4824000,"El Paso city, Texas",195667,2766,119894,3098,75773,3580
1600000US4826232,4826232,"Flower Mound town, Texas",20017,1222,18310,1258,1707,708
1600000US4827000,4827000,"Fort Worth city, Texas",220880,4799,133732,4476,87148,4598
1600000US4827684,4827684,"Frisco city, Texas",30191,1876,24577,1716,5614,1248
1600000US4829000,4829000,"Garland city, Texas",76174,3361,50859,2452,25315,2637
1600000US4830464,4830464,"Grand Prairie city, Texas",49473,2928,33574,2268,15899,1979
1600000US4835000,4835000,"Houston city, Texas",748323,8860,347865,6226,400458,9265
1600000US4837000,4837000,"Irving city, Texas",75099,3301,28774,1913,46325,3118
1600000US4839148,4839148,"Killeen city, Texas",35356,2177,18318,1558,17038,2322
1600000US4841464,4841464,"Laredo city, Texas",57042,1634,36381,2071,20661,2141
1600000US4841980,4841980,"League City city, Texas",24409,1591,19291,1574,5118,1124
1600000US4842508,4842508,"Lewisville city, Texas",32948,2000,15584,1573,17364,1831
1600000US4843888,4843888,"Longview city, Texas",30006,1543,17383,1345,12623,1571
1600000US4845000,4845000,"Lubbock city, Texas",85805,2179,47174,2270,38631,2258
1600000US4845384,4845384,"McAllen city, Texas",42314,2825,28731,2297,13583,2176
1600000US4845744,4845744,"McKinney city, Texas",36790,2223,26774,1968,10016,1758
1600000US4847892,4847892,"Mesquite city, Texas",46026,2718,31100,2285,14926,2058
1600000US4848072,4848072,"Midland city, Texas",39190,1447,25458,1453,13732,1349
1600000US4848804,4848804,"Missouri City city, Texas",18741,1602,17115,1700,1626,698
1600000US4853388,4853388,"Odessa city, Texas",36033,1725,24642,1486,11391,1352
1600000US4856000,4856000,"Pasadena city, Texas",48204,2984,27706,2046,20498,2322
1600000US4856348,4856348,"Pearland city, Texas",22466,1622,19006,1720,3460,1022
1600000US4858016,4858016,"Plano city, Texas",94324,3305,64094,2568,30230,2893
1600000US4861796,4861796,"Richardson city, Texas",36297,2208,23989,1423,12308,1692
1600000US4863500,4863500,"Round Rock city, Texas",26938,1413,18735,1344,8203,1251
1600000US4864472,4864472,"San Angelo city, Texas",36130,1557,22651,1554,13479,1577
1600000US4865000,4865000,"San Antonio city, Texas",444746,5365,270517,5523,174229,5456
1600000US4870808,4870808,"Sugar Land city, Texas",20175,1379,16980,1321,3195,832
1600000US4872656,4872656,"The Woodlands CDP, Texas",22756,1696,16671,1220,6085,1140
1600000US4874144,4874144,"Tyler city, Texas",33583,1688,20283,1384,13300,1540
1600000US4876000,4876000,"Waco city, Texas",41612,1783,20391,1542,21221,1796
1600000US4879000,4879000,"Wichita Falls city, Texas",39169,1516,21846,1460,17323,1868
1600000US4955980,4955980,"Ogden city, Utah",28283,1703,16924,1350,11359,1513
1600000US4957300,4957300,"Orem city, Utah",26448,1356,16466,1198,9982,1236
1600000US4962470,4962470,"Provo city, Utah",32044,1669,12765,1235,19279,1546
1600000US4965330,4965330,"St. George city, Utah",25720,1632,16924,1423,8796,1485
1600000US4967000,4967000,"Salt Lake City city, Utah",73172,2623,38954,1905,34218,2035
1600000US4967440,4967440,"Sandy city, Utah",28638,1594,23758,1336,4880,1061
1600000US4982950,4982950,"West Jordan city, Utah",28267,1621,23249,1567,5018,979
1600000US4983470,4983470,"West Valley City city, Utah",34898,2047,24876,1707,10022,1467
1600000US5101000,5101000,"Alexandria city, Virginia",61519,1671,29744,2111,31775,2320
1600000US5103000,5103000,"Arlington CDP, Virginia",85337,1912,45723,2472,39614,2639
1600000US5116000,5116000,"Chesapeake city, Virginia",77686,1155,59403,2077,18283,1934
1600000US5121088,5121088,"Dale City CDP, Virginia",20866,1923,16026,1682,4840,1336
1600000US5135000,5135000,"Hampton city, Virginia",54628,1313,32728,1892,21900,1872
1600000US5147672,5147672,"Lynchburg city, Virginia",25320,1439,14638,1307,10682,1356
1600000US5156000,5156000,"Newport News city, Virginia",72688,1322,38203,2109,34485,2411
1600000US5157000,5157000,"Norfolk city, Virginia",86867,1952,41326,1926,45541,2109
1600000US5164000,5164000,"Portsmouth city, Virginia",38957,1122,22966,1349,15991,1371
1600000US5167000,5167000,"Richmond city, Virginia",81193,1824,37339,1866,43854,2273
1600000US5168000,5168000,"Roanoke city, Virginia",40595,1438,24135,1604,16460,1959
1600000US5176432,5176432,"Suffolk city, Virginia",30274,680,21822,1125,8452,1095
1600000US5182000,5182000,"Virginia Beach city, Virginia",161633,2110,112476,2719,49157,2734
1600000US5305210,5305210,"Bellevue city, Washington",50464,2337,28347,1701,22117,2039
1600000US5305280,5305280,"Bellingham city, Washington",33397,1930,15343,1511,18054,1779
1600000US5322640,5322640,"Everett city, Washington",40494,2495,19026,1454,21468,2144
1600000US5323515,5323515,"Federal Way city, Washington",33099,2195,20247,1258,12852,1669
1600000US5335415,5335415,"Kent city, Washington",33580,2107,16939,1593,16641,1860
1600000US5363000,5363000,"Seattle city, Washington",259163,4620,134524,4278,124639,4427
1600000US5367000,5367000,"Spokane city, Washington",85706,2444,50058,2120,35648,2205
1600000US5367167,5367167,"Spokane Valley city, Washington",34869,1566,22810,1543,12059,1513
1600000US5370000,5370000,"Tacoma city, Washington",77166,2858,42022,2188,35144,2896
1600000US5374060,5374060,"Vancouver city, Washington",61812,1987,34576,1732,27236,2010
1600000US5380010,5380010,"Yakima city, Washington",30491,1731,16758,1404,13733,1652
1600000US5502375,5502375,"Appleton city, Wisconsin",27906,1347,18928,1246,8978,1216
1600000US5531000,5531000,"Green Bay city, Wisconsin",39869,1568,23555,1222,16314,1379
1600000US5539225,5539225,"Kenosha city, Wisconsin",35509,1525,20974,1082,14535,1602
1600000US5548000,5548000,"Madison city, Wisconsin",91622,3093,49986,2104,41636,2607
1600000US5553000,5553000,"Milwaukee city, Wisconsin",228327,3374,109275,3735,119052,3806
1600000US5566000,5566000,"Racine city, Wisconsin",30788,1642,17734,1625,13054,1593
1600000US5584250,5584250,"Waukesha city, Wisconsin",27743,1476,15797,1022,11946,1530
